Name,Category,List-Price,Price,Total Review,Rating Average,Discount,Discount Rate
Nước Xả Vải Comfort Cho Da Nhạy Cảm (3.2L/Túi)  - Phù Hợp Với Làn Da Em Bé,Chăm sóc nhà cửa,209000,168000,1777,4.7,41000,20
Túi Nước Giặt Omo Matic Bền Đẹp Cửa Trước 3.7Kg,Chăm sóc nhà cửa,199000,150000,32,5,49000,25
Túi Nước Giặt OMO Matic Comfort Hương Tinh dầu thơm 3.7kg,Chăm sóc nhà cửa,199000,161000,26,5,38000,19
Nước Giặt Ariel Hương Downy Túi 3.2Kg,Chăm sóc nhà cửa,186000,149000,224,4.8,37000,20
Combo 2 Túi Nước Giặt Omo Matic Bền Đẹp Cửa Trước 2.0Kg,Chăm sóc nhà cửa,254000,203000,255,4.8,51000,20
Nước Xả Làm Mềm Vải Comfort Chăm Sóc Chuyên Sâu Đậm Đặc Một Lần Xả Hương Ban Mai Túi 3.2L,Chăm sóc nhà cửa,179000,147000,477,4.8,32000,18
Túi Nước Giặt Omo Matic Cửa Trước Khử Mùi Thư Thái,Chăm sóc nhà cửa,127000,109000,601,4.8,18000,14
Nước Giặt Ariel Đậm Đặc Dạng Túi 3.6kg,Chăm sóc nhà cửa,202000,155000,533,4.8,47000,23
Nước Rửa Chén Sunlight Thiên Nhiên Muối Khoáng Và Lô Hội (3.6 kg) - Mới,Chăm sóc nhà cửa,114000,100000,994,4.8,14000,12
Nước Xả Vải Downy Nắng Mai  (3.5L/ Túi) - Giữ quần áo tươi mới - Hương thơm tươi mới kéo dài ,Chăm sóc nhà cửa,215000,176000,130,4.8,39000,18
Nước Xả Làm Mềm Vải Comfort Chăm Sóc Chuyên Sâu Hương Nước Hoa Thiên Nhiên Sophia túi 3.8L,Chăm sóc nhà cửa,219000,179000,335,4.8,40000,18
Túi Nước Giặt OMO Dịu Nhẹ Trên Da 2.9kg,Chăm sóc nhà cửa,165000,136000,403,4.8,29000,18
Combo 2 Túi Nước Giặt OMO Matic Comfort Hương Tinh dầu thơm 2.9kg,Chăm sóc nhà cửa,330000,298000,245,4.8,32000,10
Túi Nước Giặt Omo Matic Cửa Trên (4.0Kg),Chăm sóc nhà cửa,199000,161000,69,4.6,38000,19
Combo 2 Nước Giặt Ariel Matic Hương Downy 3.2kg,Chăm sóc nhà cửa,404000,307000,143,5,97000,24
Nước Xả Vải Downy Hương Nước Hoa Quyến Rũ (Huyền Bí) 4L (Dạng chai),Chăm sóc nhà cửa,260000,215000,57,5,45000,17
Túi Nước Giặt Omo Matic Bền Đẹp Cửa Trước 2.9Kg,Chăm sóc nhà cửa,165000,135000,225,4.7,30000,18
Nước Giặt Ariel Dịu Nhẹ Cho Da Nhạy Cảm Dạng Túi 3.25kg - Mềm mại ngát hương - An toàn cho da em bé,Chăm sóc nhà cửa,191000,154000,188,4.8,37000,19
Combo 2 Túi Nước Giặt Xả Maxkleen Hương Hoa Nắng (3.8kg/túi),Chăm sóc nhà cửa,380000,282000,311,4.8,98000,26
Combo 2 Túi nước giặt xả Maxkleen Hương Huyền Diệu 3.8kg/túi ,Chăm sóc nhà cửa,380000,282000,299,4.8,98000,26
Nước Rửa Chén Diệt Khuẩn Sunlight Chanh Và Lá Bạc Hà Mới (3.6kg/Chai) - Mới,Chăm sóc nhà cửa,114000,97000,417,4.8,17000,15
Nước Xả Vải Downy Hương Nước Hoa Huyền Bí (3.5L/ Túi),Chăm sóc nhà cửa,238000,194000,171,4.7,44000,18
Nước Giặt Downy Vườn Hoa Thơm Ngát Dạng Túi 2.15KG,Chăm sóc nhà cửa,148000,102000,85,4.8,46000,31
Nước Xả Làm Mềm Vải Comfort Chăm Sóc Chuyên Sâu Đậm Đặc Một Lần Xả Hương Ban Mai Túi 3.8L,Chăm sóc nhà cửa,219000,178000,108,4.7,41000,19
"[XỊT LÀ SẠCH] Nước tẩy cặn canxi HGO PLUS trên vòi rửa inox, vách kính, bồn rửa sứ trong nhà tắm. Chai 500ml ",Chăm sóc nhà cửa,195000,99000,21,4.5,96000,49
Combo 2 Nước Giặt Ariel Đậm Đặc 3.5kg,Chăm sóc nhà cửa,382000,309000,120,4.8,73000,19
Combo 3 Túi Nước Giặt Xả Maxkleen Hương Nước Hoa Huyền Diệu (2.4kg/túi),Chăm sóc nhà cửa,408000,282000,296,5,126000,31
Nước Giặt Ariel Giữ Màu Túi 3.2kg - Công nghệ 3D Làm sạch sâu - Giữ màu không phai,Chăm sóc nhà cửa,202000,129000,88,4.8,73000,36
Nước Lau Sàn Sunlight Tinh Dầu Thiên Nhiên - Hương Hoa Lily 3.8kg,Chăm sóc nhà cửa,93000,76000,525,4.8,17000,18
Nước Xả Làm Mềm Vải Comfort Chăm Sóc Chuyên Sâu Hương Nước Hoa Thiên Nhiên Bella Túi 3.8L,Chăm sóc nhà cửa,219000,180000,160,4.8,39000,18
Nước Xả Vải Downy Chống Khuẩn Ngăn Mùi Hôi 4L (Dạng chai),Chăm sóc nhà cửa,242000,196000,147,4.7,46000,19
 Nước xả vải Downy Hương Nắng mai 4L (Dạng chai),Chăm sóc nhà cửa,242000,165000,88,5,77000,32
Nước Xả Làm Mềm Vải Comfort Chăm Sóc Chuyên Sâu Ngăn Ngừa Mùi Hôi Hương Tươi Mát túi 3.8L,Chăm sóc nhà cửa,219000,173000,95,5,46000,21
Nước Giặt Ariel Khử Mùi Ẩm Mốc Túi 3.2kg,Chăm sóc nhà cửa,202000,145000,135,4.7,57000,28
Nước Xả Vải Downy Đam Mê Dạng Túi 3L,Chăm sóc nhà cửa,209000,171000,98,4.7,38000,18
Chai Nước Giặt Xả Maxkleen Hương Vườn Sớm Mai Sạch Khuẩn Thơm Mềm Tiện Lợi & Tiết Kiệm 2.4Kg Tặng Túi 600G,Chăm sóc nhà cửa,203000,138000,341,4.8,65000,32
Nước xả vải em bé Comfort Kháng Khuẩn Dịu Nhẹ Túi 2.4L,Chăm sóc nhà cửa,170000,142000,172,4.7,28000,16
 Thuốc diệt gián hộp 12 viên - Nội địa Nhật,Chăm sóc nhà cửa,321000,50000,54,4.7,271000,84
Nước Rửa Chén Sunlight Mềm Dịu Hương Bưởi Tây & Hoa Anh Đào Chai 3.6kg,Chăm sóc nhà cửa,114000,95000,3,5,19000,17
Nước Xả Làm Mềm Vải Comfort Chăm Sóc Chuyên Sâu Ngăn Ngừa Mùi Hôi Hương Tươi Mát túi 3.2L,Chăm sóc nhà cửa,179000,151000,346,4.8,28000,16
Nước Lau Sàn Sunlight Thiên Nhiên Chiết Xuất Chanh Yuzu & Tinh Dầu Sả 3.6Kg,Chăm sóc nhà cửa,100000,87000,160,4.8,13000,13
Nước Giặt Ariel Đậm Đặc Dạng Túi 3.5kg,Chăm sóc nhà cửa,191000,155000,43,4.8,36000,19
Combo 2 Túi Nước Xả Vải Downy Hương Nước Hoa Huyền Bí (2.3L/ Túi) - Công nghệ nước hoa mới - Lưu hương bền lâu,Chăm sóc nhà cửa,304000,275000,82,4.7,29000,10
Nước Rửa Chén Khử Mùi Tanh Sunlight Matcha Trà Nhật Mới (3.6kg / Chai) - Mới,Chăm sóc nhà cửa,114000,99000,348,4.8,15000,13
Nước Xả Làm Mềm Vải Comfort Chăm Sóc Chuyên Sâu Đậm Đặc Một Lần Xả Hương Ban Mai Túi 2.8L,Chăm sóc nhà cửa,170000,144000,83,4.8,26000,15
Combo 2 Túi Nước Giặt OMO Dịu Nhẹ Trên Da 2.0kg,Chăm sóc nhà cửa,254000,206000,397,4.8,48000,19
Nước Giặt Ariel Cửa Trước Tươi Mát Rực Rỡ 3.6Kg,Chăm sóc nhà cửa,233000,155000,62,4.8,78000,33
Nước Xả Vải Downy Đam Mê Dạng Túi 2.3L ,Chăm sóc nhà cửa,159000,129000,24,4.5,30000,19
Nước xả vải em bé Comfort Kháng Khuẩn Dịu Nhẹ Túi 1.5L,Chăm sóc nhà cửa,110000,94000,38,5,16000,15
Túi Nước Giặt Omo Matic Bền Đẹp Cửa Trước 2.0Kg,Chăm sóc nhà cửa,127000,105000,148,4.8,22000,17
THÙNG VIÊN GIẶT TIDE PODS HE LAUNDRY DETERGENT PODS 42x4 VIÊN (168 VIÊN),Chăm sóc nhà cửa,1350000,1050000,24,5,300000,22
Combo 2 Túi Nước Xả Vải Downy Đam Mê (2.3L/Túi) - Công nghệ nước hoa mới - Lưu hương bền lâu,Chăm sóc nhà cửa,304000,275000,78,4.8,29000,10
Túi Nước Giặt OMO Matic Comfort Hương Tinh dầu thơm 2.9kg,Chăm sóc nhà cửa,165000,135000,413,4.7,30000,18
Chai Nước Giặt Xả Maxkleen Hương Hoa Nắng Sạch Khuẩn Thơm Mềm Tiện Lợi & Tiết Kiệm 2.4Kg Tặng Túi 600G,Chăm sóc nhà cửa,203000,129000,11,5,74000,36
Combo 3 Túi Nước Giặt Xả Maxkleen 2.4kg/túi: 1 Hương Hoa nắng + 1 Hương Vườn sớm mai + 1 Hương Huyền diệu,Chăm sóc nhà cửa,408000,282000,210,5,126000,31
Nước xả làm mềm vải Comfort Chăm sóc Chuyên sâu Hương nước hoa thiên nhiên Bella túi 3.2L,Chăm sóc nhà cửa,179000,149000,165,4.8,30000,17
Nước Rửa Chén Sunlight Chanh Công Nghệ Mới Dạng Túi,Chăm sóc nhà cửa,59000,58000,317,4.8,1000,2
Combo 2 Túi Nước Giặt Ariel Matic Hương Downy (2.1Kg/ Túi),Chăm sóc nhà cửa,272000,227000,86,5,45000,17
Nước Rửa Chén Sunlight Chanh Công Nghệ Mới Dạng Túi,Chăm sóc nhà cửa,59000,58000,317,4.8,1000,2
Combo 2 Nước Xả Vải Downy Huyền Bí (3L/Túi),Chăm sóc nhà cửa,398000,341000,77,4.8,57000,14
Túi Nước Giặt OMO Matic Comfort Hương Tinh dầu thơm 2.9kg,Chăm sóc nhà cửa,165000,135000,413,4.7,30000,18
VIÊN GIẶT TIDE PODS HE LAUNDRY DETERGENT PODS 42 VIÊN (MẪU MỚI NHẤT),Chăm sóc nhà cửa,350000,249000,3,5,101000,29
Combo 2 Túi Nước Giặt OMO Matic Comfort Hương Tinh dầu thơm 2.9kg,Chăm sóc nhà cửa,330000,298000,245,4.8,32000,10
Nước Xả Vải Downy Đam Mê 3.5L,Chăm sóc nhà cửa,225000,194000,96,4.8,31000,14
Combo 2 Chai Vim Diệt Khuẩn Xanh Biển Bất Khả Chiến Bại 900ml,Chăm sóc nhà cửa,72000,58000,24,4.7,14000,19
"[ComBo 2 Hộp ] Thông Tắc Ngẽn Bồn Cầu, Thông Tắc Ngẽn Cống, Bột thông cống mạnh. Loại lớn 260g. Xử Lý nhanh tắc ngẽn",Chăm sóc nhà cửa,169000,54500,39,4.5,114500,68
Túi Nước Giặt Omo Matic Cửa Trước Khử Mùi Thư Thái,Chăm sóc nhà cửa,199000,148000,601,4.8,51000,26
Thuốc diệt kiến gián sinh học không mùi combo 2 chai,Chăm sóc nhà cửa,99000,33000,44,4.5,66000,67
Nước Xả Vải Downy Hương Đam Mê 4L (Dạng chai),Chăm sóc nhà cửa,312000,199000,39,4.8,113000,36
Combo 3 Túi Nước Giặt Xả Maxkleen Hương Hoa Nắng (2.4kg/túi),Chăm sóc nhà cửa,408000,282000,131,4.8,126000,31
Nước xả vải em bé Comfort Kháng Khuẩn Dịu Nhẹ Túi 1.5L,Chăm sóc nhà cửa,110000,94000,38,5,16000,15
Combo Nước giặt xả Maxkleen Hương Cam sả: 1 Chai 2.4kg + 1 Túi 600g,Chăm sóc nhà cửa,203000,139000,8,4.8,64000,32
Combo 2 Nước Rửa Chén Seventh Generation Lavender&Mint (750ml),Chăm sóc nhà cửa,130000,106000,276,4.7,24000,18
Nước Rửa Chén Diệt Khuẩn Sunlight Chanh Và Lá Bạc Hà Mới (3.6kg/Chai) - Mới,Chăm sóc nhà cửa,114000,97000,417,4.8,17000,15
Nước Xả Làm Mềm Vải Comfort Chăm Sóc Chuyên Sâu Đậm Đặc Một Lần Xả Hương Ban Mai Túi 2.8L,Chăm sóc nhà cửa,170000,144000,83,4.8,26000,15
Viên giặt Tide Pods 4 trong 1 Downy (104 viên),Chăm sóc nhà cửa,1000000,699000,7,5,301000,30
Nước xả vải Downy Hương nước hoa Đam Mê 4L,Chăm sóc nhà cửa,260000,215000,49,4.8,45000,17
Nước Giặt Ariel Cửa Trước Bung Tỏa Đam Mê 3.25Kg,Chăm sóc nhà cửa,233000,155000,47,4.6,78000,33
Nước Xả Làm Mềm Vải Comfort Chăm Sóc Chuyên Sâu Ngăn Ngừa Mùi Hôi Hương Tươi Mát túi 3.8L,Chăm sóc nhà cửa,219000,173000,95,5,46000,21
Túi Nước Giặt Omo Matic Bền Đẹp Cửa Trước 2.9Kg,Chăm sóc nhà cửa,165000,135000,225,4.7,30000,18
Giấy Vệ Sinh Choice L (24 Cuộn),Chăm sóc nhà cửa,49000,49000,123,4.7,0,0
Nước Giặt Ariel Matic Hương Downy Túi 2.1Kg,Chăm sóc nhà cửa,139000,114000,91,4.8,25000,18
Nước Rửa Chén Khử Mùi Tanh Sunlight Matcha Trà Nhật Mới (3.6kg / Chai) - Mới,Chăm sóc nhà cửa,114000,99000,348,4.8,15000,13
Nước Xả Vải Downy Đóa Hoa Ngọt Ngào Dạng Chai 800ml,Chăm sóc nhà cửa,66000,55000,86,4.6,11000,17
"Siêu tẩy dầu mỡ HGO [XỊT LÀ SẠCH] tẩy dầu mỡ cháy két trên lưới lọc máy hút mùi, tường gạch ốp, mặt bếp ga, bếp từ hiệu quả an toàn chất lượng",Chăm sóc nhà cửa,155000,95000,90,4.5,60000,39
Combo 2 túi nước giặt xả Maxkleen hương Vườn Sớm Mai 3.8kg/túi ,Chăm sóc nhà cửa,380000,282000,124,5,98000,26
"[XỊT LÀ SẠCH] Nước tẩy cặn canxi HGO PLUS trên vòi rửa inox, vách kính, bồn rửa sứ trong nhà tắm. Chai 500ml ",Chăm sóc nhà cửa,195000,99000,21,4.5,96000,49
Diệt kiến dạng Gel Bayer Maxforce Quantum 0.03% (12g),Chăm sóc nhà cửa,160000,149000,82,4.7,11000,7
Combo 2 Túi Nước Giặt OMO Matic Bền Đẹp Lựu Và Tre Cho Máy Giặt Cửa Trước (2.3kg/Túi),Chăm sóc nhà cửa,278000,203000,901,4.7,75000,27
"Hộp 12 Viên Tẩy Vệ Sinh Lồng Máy Giặt, Diệt Khuẩn Và Tẩy Chất Cặn Lồng Máy Giặt Hiệu Quả",Chăm sóc nhà cửa,175000,23900,17,4.1,151100,86
Nước Lau Sàn Sunlight Tinh Dầu Thiên Nhiên - Hương hoa Diên Vỹ (2.6kg/Túi),Chăm sóc nhà cửa,57000,56000,82,4.8,1000,2
Nước Rửa Chén Sunlight Chanh Công Nghệ Mới Dạng Chai,Chăm sóc nhà cửa,95000,86000,271,4.8,9000,9
Combo 2 Vim Diệt Khuẩn Trắng Sáng Hương Chanh Sả Dịu Mát 880ml,Chăm sóc nhà cửa,76000,67000,275,4.7,9000,12
Nước Tẩy Bồn Cầu Vim Diệt Khuẩn (900ml) - Xanh Biển,Chăm sóc nhà cửa,36000,36000,36,4.8,0,0
Nước Xả Làm Mềm Vải Comfort Chăm Sóc Chuyên Sâu Ngăn Ngừa Mùi Hôi Hương Tươi Mát túi 3.2L,Chăm sóc nhà cửa,179000,151000,346,4.8,28000,16
DẠNG GÓI 20 VIÊN | HỘP 100 VIÊN - THUỐC DIỆT CHUỘT STORM - DẠNG VIÊN NÉN - ĐƠN GIẢN DỄ SỬ DỤNG - AN TOÀN VỚI NGƯỜI SỬ DỤNG VÀ MÔI TRƯỜNG,Chăm sóc nhà cửa,39000,27000,90,4.5,12000,31
Nước Lau Sàn Sunlight Hương Hoa Thiên Nhiên 3.6kg,Chăm sóc nhà cửa,100000,97000,277,4.8,3000,3
Combo 2 Túi Nước Giặt Ariel Dịu Nhẹ Cho Da Nhạy Cảm (2.15kg/ Túi) - Mềm mại ngát hương - An toàn cho da em bé,Chăm sóc nhà cửa,278000,227000,56,4.8,51000,18
Nước Xả Làm Mềm Vải Comfort Chăm Sóc Chuyên Sâu Ngăn Ngừa Mùi Hôi Hương Tươi Mát túi 2.8L,Chăm sóc nhà cửa,170000,146000,41,4.6,24000,14
Khăn Giấy Lụa Tiết Kiệm Choice L (SL) 2 lớp (180 Tờ / Gói) (Bao Bì Mới),Chăm sóc nhà cửa,35000,31700,228,4.7,3300,9
Combo 2 Nước Rửa Chén Sunlight Thiên nhiên Muối khoáng Và Lô hội (2.1kg x 2),Chăm sóc nhà cửa,130000,118000,342,4.8,12000,9
Nước Giặt Lix Đậm Đặc ,Chăm sóc nhà cửa,85000,61000,100,4.8,24000,28
Nước Xả Làm Mềm Vải Comfort Chăm Sóc Chuyên Sâu Hương Nước Hoa Thiên Nhiên Bella Túi 2.8L,Chăm sóc nhà cửa,170000,144000,37,4.8,26000,15
Nước giặt Ariel Dạng Túi Dịu Nhẹ Cho Da Nhạy Cảm 2.15kg,Chăm sóc nhà cửa,139000,114000,106,4.7,25000,18
Bột Giặt Tide Hương Downy (5kg),Chăm sóc nhà cửa,209000,168000,124,4.7,41000,20
Thuốc viên diệt gián nội địa Nhật Bản,Chăm sóc nhà cửa,232700,51000,10,4.8,181700,78
Combo 2 Nước xả vải em bé Comfort Kháng Khuẩn Dịu Nhẹ Túi 2.4L,Chăm sóc nhà cửa,340000,274000,113,4.6,66000,19
Combo 3 Túi Nước Giặt Xả Maxkleen Hương Vườn Sớm Mai (2.4kg/túi),Chăm sóc nhà cửa,408000,282000,70,4.8,126000,31
Túi Nước Giặt OMO Dịu Nhẹ Trên Da 2.0kg,Chăm sóc nhà cửa,127000,107000,161,5,20000,16
Nước Giặt Xả Công Nghê Thái Lan Di-mark 5 lít (đen) Thơm Lâu Công Nghệ Mới 5 IN 1,Chăm sóc nhà cửa,380000,155000,121,4.6,225000,59
Nước Lau Sàn Sunlight Thiên Nhiên Chiết Xuất Chanh Yuzu & Tinh Dầu Sả 3.6Kg,Chăm sóc nhà cửa,100000,87000,160,4.8,13000,13
Muối rửa bát Finish 4.0 kg,Chăm sóc nhà cửa,500000,230000,142,4.7,270000,54
Combo 3 lọ Thuốc diệt kiến gián sinh học Hanpet- Dung dịch diệt kiến tận gốc,Chăm sóc nhà cửa,59000,44300,126,4.5,14700,25
Nước Xả Vải Downy Cuốn Hút Dạng Túi,Chăm sóc nhà cửa,159000,138000,77,4.7,21000,13
Combo 2 Túi Nước Giặt Ariel Matic Đậm Đặc (2.3kg/ Túi),Chăm sóc nhà cửa,272000,229000,247,4.6,43000,16
Giấy Vệ Sinh Pulppy Classic (10 Cuộn),Chăm sóc nhà cửa,81900,81900,115,4.7,0,0
Nước Xả Làm Mềm Vải Comfort Chăm Sóc Chuyên Sâu Ngăn Ngừa Mùi Hôi Hương Tươi Mát túi 2.8L,Chăm sóc nhà cửa,170000,146000,41,4.6,24000,14
Combo 10 Viên Tẩy Bồn Cầu,Chăm sóc nhà cửa,75000,17900,3,4.7,57100,76
Nước Xả Làm Mềm Vải Comfort Chăm Sóc Chuyên Sâu Đậm Đặc Một Lần Xả Hương Ban Mai Túi 2.8L,Chăm sóc nhà cửa,170000,144000,83,4.8,26000,15
Thuốc diệt chuột tiêu diệt cả đàn chuột hàng xách tay Nhật Bản,Chăm sóc nhà cửa,289000,94000,24,3.6,195000,67
Viên rửa bát Finish All in one 100 viên,Chăm sóc nhà cửa,750000,650000,6,5,100000,13
Hộp 4 Viên Nén Vệ Sinh Lồng Giặt OMO Matic 80gr,Chăm sóc nhà cửa,85000,85000,0,0,0,0
Nước Xả Vải Downy Hương Nắng Mai 8.5L,Chăm sóc nhà cửa,446000,357000,27,4.7,89000,20
Nước Lau Sàn Sunlight Tinh Dầu Thiên Nhiên - Hương Hoa Diên Vỹ 3.8kg,Chăm sóc nhà cửa,93000,80000,202,4.8,13000,14
Nước Hoa Tinh Dầu Thơm Phòng - Tinh Dầu Khô MissuVN,Chăm sóc nhà cửa,109000,28000,43,4.2,81000,74
Combo 5 hộp khăn giấy Pulppy ( 180 tờ / hộp ),Chăm sóc nhà cửa,165000,101000,81,4.6,64000,39
Combo 2 Nước Giặt Ariel Matic Đậm Đặc (3.6Kg/ Túi),Chăm sóc nhà cửa,468000,289000,9,4.6,179000,38
Viên Thả Làm Sạch Bồn Cầu (1 Gói 10 Viên),Chăm sóc nhà cửa,45000,14400,13,4.5,30600,68
Bột giặt Surf Hương nước xả vải (Hồng) Gói lớn 5.8kg,Chăm sóc nhà cửa,169000,115000,46,4.7,54000,32
Combo 2 Túi Nước Xả Vải Downy Hương Hoa Nắng Mai (2.4L/ Túi),Chăm sóc nhà cửa,304000,239000,0,0,65000,21
Nước Tẩy Diệt Khuẩn Bồn Cầu Vim Zero Mảng Bám (750ml),Chăm sóc nhà cửa,34000,29000,312,4.8,5000,15
Nước Xả Vải Downy Dịu Nhẹ Túi 2.6L cho Da Nhạy Cảm,Chăm sóc nhà cửa,165500,143000,55,4.7,22500,14
Nước Lau Sàn Sunlight Tinh Dầu Thiên Nhiên - Hương hoa Diên Vỹ (2.6kg/Túi),Chăm sóc nhà cửa,57000,45000,10,5,12000,21
Combo 2 Túi Nước Giặt OMO Matic Comfort Hương Tinh dầu thơm 2.0kg,Chăm sóc nhà cửa,254000,218000,94,4.6,36000,14
Viên rửa bát Finish Nhật 150 viên,Chăm sóc nhà cửa,500000,325000,13,4.7,175000,35
Nước Xả Vải Downy Mềm Mại Tinh Khiết (3.5L/ Túi) ,Chăm sóc nhà cửa,219000,165000,156,4.6,54000,25
"COMBO 2 Hộp Viên Tẩy Lồng Máy Giặt Khử Sạch Cặn Bẩn, Vệ Sinh Máy Giặt Diệt Khuẩn Và Khử Mùi Lồng Máy - Đa Năng Phù Hợp Sử Dụng Cho Nhiều Loại Máy Giặt (COMBO 12 Viên)",Chăm sóc nhà cửa,190000,36000,16,3.7,154000,81
Nước Giặt Ariel Cửa Trước Hương Đam Mê Dạng Túi (2.15Kg/Túi),Chăm sóc nhà cửa,160000,129000,3,5,31000,19
Bột Thông Cống Cực Mạnh-268g-TVS55-Hạt Trắng,Chăm sóc nhà cửa,800001,37000,3,5,763001,95
"Hộp đốt nhang muỗi chuyên dụng, khay đựng hương muỗi an toàn chống cháy siêu tiện dụng",Chăm sóc nhà cửa,99000,84900,0,0,14100,14
Nước xả vải em bé Comfort Kháng Khuẩn Dịu Nhẹ Túi 2.4L,Chăm sóc nhà cửa,170000,142000,172,4.7,28000,16
Máy Xịt Phòng Tự Động 60 Ngày Glade - Hương Oải Hương Và Vani Ngọt Ngào,Chăm sóc nhà cửa,265900,221000,4,5,44900,17
Nước Giặt Lix Hương Nước Hoa 3.8Kg NGH01 - Tẩy Sạch Vết Bẩn Cực Mạnh,Chăm sóc nhà cửa,179000,109000,76,4.7,70000,39
Nước Giặt Downy Biển Xanh Tươi Mát 3.25kg,Chăm sóc nhà cửa,217000,159000,2,5,58000,27
"Chất thông tắc Cầu, Cống Sifa chống hôi Siêu nhanh Siêu mạnh 5 phút",Chăm sóc nhà cửa,140000,77406,135,4.2,62594,45
PHẤN DIỆT KIẾN VÀ CÔN TRÙNG VIPESCO - DIỆT TRỪ CÔN TRÙNG QUANH NHÀ - DẠNG VIÊN PHẤN - CÓ THỂ VẼ HOẶC NGHIỀN BỘT RẮC,Chăm sóc nhà cửa,25000,25000,84,4.6,0,0
Bột Giặt Lix Extra Hương Hoa 6Kg EB006 - Tẩy Sạch Vết Bẩn Cực Mạnh,Chăm sóc nhà cửa,185000,125000,8,5,60000,32
1 Thùng Viên Giặt Tide Power PODS Hygienic Clean Detergent Mỹ - 68 viên,Chăm sóc nhà cửa,820000,640000,5,4.8,180000,22
Nước Xả Vải Downy Huyền Bí (3L/Túi),Chăm sóc nhà cửa,199000,171000,49,4.8,28000,14
Bình Xịt Muỗi Jumbo Vape FIK Hương Cam Chanh 100712620 (600ml),Chăm sóc nhà cửa,66300,54000,108,4.7,12300,19
"Combo muối rửa bát Finish 1,5kg+viên rửa bát Finish 120 viên+Nước làm bóng bát chén finish 800ml",Chăm sóc nhà cửa,2300000,799995,4,3.8,1500005,65
Muối rửa bát finish 1.5kg,Chăm sóc nhà cửa,550000,143000,1,5,407000,74
Combo 2 Nước Rửa Chén Sunlight Khử mùi tanh Matcha Trà Nhật (2.1kg x 2),Chăm sóc nhà cửa,130000,116000,253,5,14000,11
Xịt Thơm Quần Áo Fabric Perfume Nội Địa Hàn Quốc Cao Cấp (250ml) – Hàng Nội Địa Chính Hãng,Chăm sóc nhà cửa,200000,89000,32,3.5,111000,56
Bình xịt Phòng tinh dầu Hương Sả Chanh 280ml JULYHOUSE ,Chăm sóc nhà cửa,249000,149000,164,4.6,100000,40
Nước Giặt OMO Matic Comfort Tinh Dầu Thơm Cho Máy Giặt Cửa Trên (3.7Kg/Túi),Chăm sóc nhà cửa,191000,150000,51,4.7,41000,21
Nước Giặt Lix Nha Đam Aloe Vera 4Kg NG400 - Bảo Vệ Da Tay,Chăm sóc nhà cửa,125000,96000,36,4.8,29000,23
Nước Xả Vải Downy Hương Nước Hoa Đam Mê 8.5L,Chăm sóc nhà cửa,500000,405000,48,4.8,95000,19
Combo 2 Nước Lau Bếp Cif Thiên Nhiên 500ml Chanh & Baking Soda Sạch Dầu Mỡ An Toàn,Chăm sóc nhà cửa,66000,61000,85,4.5,5000,8
"Hộp 8 Viên Tẩy Lồng Máy Giặt SPEVI Dạng Sủi Xuất Xứ Nhật Bản - Vệ Sinh Máy Giặt, Diệt Sạch Vi Khuẩn, Vệ Sinh Lồng Máy Giặt Và Khử Mùi Hiệu Quả - Hàng chính hãng",Chăm sóc nhà cửa,129000,39000,187,4.3,90000,70
2 lọ diệt kiến gián sinh học không mùi,Chăm sóc nhà cửa,120000,12500,241,4.5,107500,90
Combo 2 Nước Giặt Ariel Khử Mùi Ẩm Mốc 3.2kg,Chăm sóc nhà cửa,390000,307000,47,4.7,83000,21
Nước Xả Vải Downy Đam Mê Dạng Túi (750ml/Túi),Chăm sóc nhà cửa,56000,55000,56,4.8,1000,2
"Diệt côn trùng gián, kiến, kiến ba khoang, muỗi, ruồi, mối, mọt 100% Sinh học Thảo mộc 10s Chai xịt 100ml An toàn cho sức khỏe em bé và người già , đã được Bộ Y tế cho phép lưu hành",Chăm sóc nhà cửa,55000,55000,26,4.5,0,0
Bột Giặt Ariel Chuyên Dụng (9kg),Chăm sóc nhà cửa,390000,293000,66,4.6,97000,25
Máy Tính Bảng Samsung Galaxy Tab S7 Wifi T870 (6GB/128GB) - Hàng Chính Hãng,Điện Thoại - Máy Tính Bảng,14990000,14590000,42,5,400000,3
Điện Thoại Vsmart Live 4 (6GB/64GB) - Hàng Chính Hãng,Điện Thoại - Máy Tính Bảng,4790000,3690000,0,0,1100000,23
Điện Thoại iPhone 12 Pro Max 128GB - Hàng Chính Hãng,Điện Thoại - Máy Tính Bảng,33990000,29700000,455,5,4290000,13
Điện Thoại Realme C11 (2GB/32GB) - Hàng Chính Hãng,Điện Thoại - Máy Tính Bảng,2690000,2150000,137,4.8,540000,20
Máy tính bảng Vankyo MatrixPad S20 - Hàng Chính Hãng,Điện Thoại - Máy Tính Bảng,5290000,3490000,7,4.6,1800000,34
Điện Thoại Samsung Galaxy M31 (6GB/128GB) - Hàng Chính Hãng,Điện Thoại - Máy Tính Bảng,6490000,4890000,1769,4.7,1600000,25
Điện Thoại Nokia 105 Dual Sim (2019) - Hàng Chính Hãng,Điện Thoại - Máy Tính Bảng,360000,346000,2,5,14000,4
Điện Thoại Oppo A12 (3GB/32GB) - Hàng Chính Hãng,Điện Thoại - Máy Tính Bảng,2990000,2390000,196,4.7,600000,20
Máy tính bảng Kindle Fire HD8 Plus 2020 - Ram 3Gb - 32Gb - Hàng nhập khẩu,Điện Thoại - Máy Tính Bảng,3190000,2550000,5,5,640000,20
Điện Thoại Vsmart Joy 4 - Hàng Chính Hãng,Điện Thoại - Máy Tính Bảng,3290000,2790000,1489,4.7,500000,15
Điện Thoại Samsung Galaxy M11 (3GB/32GB) - Hàng Chính Hãng,Điện Thoại - Máy Tính Bảng,3690000,2790000,1023,4.7,900000,24
Điện Thoại Samsung Galaxy A51 (6GB/128GB) - Hàng Chính Hãng,Điện Thoại - Máy Tính Bảng,7990000,5890000,286,4.6,2100000,26
Máy Đọc Sách Kindle Fire HD 10 (Đen) - Hàng Nhập Khẩu,Điện Thoại - Máy Tính Bảng,3790000,3350000,7,4.4,440000,12
Điện Thoại Xiaomi Redmi Note 10 (4GB/64GB) - Hàng Chính Hãng,Điện Thoại - Máy Tính Bảng,4690000,4090000,51,4.8,600000,13
Điện Thoại Nokia 105 Single Sim - Hàng Chính Hãng,Điện Thoại - Máy Tính Bảng,360000,335000,2,4,25000,7
Điện thoại Xiaomi POCO M3 - HÀNG CHÍNH HÃNG,Điện Thoại - Máy Tính Bảng,3990000,3179000,63,4.8,811000,20
"Máy đọc sách Kobo Clara HD 8GB đen, 6 inch, có đèn cam - Hàng nhập khẩu",Điện Thoại - Máy Tính Bảng,5000000,3245000,4,5,1755000,35
Điện thoại Xiaomi Redmi 9A (2GB/32GB) - Hàng chính hãng,Điện Thoại - Máy Tính Bảng,1990000,1990000,55,4.7,0,0
Điện Thoại iPhone 12 Pro 128GB - Hàng Chính Hãng,Điện Thoại - Máy Tính Bảng,30990000,26950000,188,5,4040000,13
Điện Thoại iPhone 11 64GB  - Hàng  Chính Hãng,Điện Thoại - Máy Tính Bảng,22990000,16290000,630,4.8,6700000,29
Điện Thoại Nokia 215 4G - Hàng Chính Hãng,Điện Thoại - Máy Tính Bảng,749000,640000,0,0,109000,15
iPad 10.2 Inch WiFi 32GB (Gen 8) New 2020 - Hàng  Chính Hãng,Điện Thoại - Máy Tính Bảng,10990000,8690000,520,4.8,2300000,21
Điện Thoại iPhone 12 Pro Max 256GB - Hàng Chính Hãng,Điện Thoại - Máy Tính Bảng,37990000,32350000,406,5,5640000,15
 Điện thoại Xiaomi Poco X3 Pro 6GB l 128GB - Hàng chính hãng,Điện Thoại - Máy Tính Bảng,6990000,5890000,15,5,1100000,16
Điện thoại di động Forme D777 - Hàng Chính Hãng,Điện Thoại - Máy Tính Bảng,399000,399000,22,4.6,0,0
Điện thoại Xiaomi POCO X3 PRO - Hàng Chính Hãng,Điện Thoại - Máy Tính Bảng,6990000,5590000,14,5,1400000,20
Điện Thoại iPhone 12 64GB - Hàng  Chính Hãng,Điện Thoại - Máy Tính Bảng,24990000,20390000,179,4.8,4600000,18
Điện Thoại Xiaomi Redmi Note 10 (6GB/128GB) - Hàng Chính Hãng,Điện Thoại - Máy Tính Bảng,5490000,4690000,24,4.6,800000,15
"Điện thoại Forme Duos 1900, màn hình 2.8inch, pin 1900mAh, font chữ lớn - Phân phối chính hãng",Điện Thoại - Máy Tính Bảng,360000,310000,15,4.6,50000,14
Điện Thoại iPhone 12 Mini 64GB - Hàng Chính Hãng,Điện Thoại - Máy Tính Bảng,21990000,16950000,85,4.7,5040000,23
Điện Thoại iPhone 11 128GB - Hàng Chính Hãng,Điện Thoại - Máy Tính Bảng,23990000,17600000,363,4.8,6390000,27
Điện Thoại Samsung Galaxy A02s (4GB/64GB) -  ĐÃ KÍCH HOẠT BẢO HÀNH ĐIỆN TỬ - Hàng Chính Hãng,Điện Thoại - Máy Tính Bảng,4190000,2875000,9,4.8,1315000,31
Điện Thoại Di Động Forme Gorilla  - Hàng Chính Hãng,Điện Thoại - Máy Tính Bảng,359000,299000,8,4.5,60000,17
Điện Thoại Samsung Galaxy A10s (2GB/32GB) - Hàng Chính Hãng,Điện Thoại - Máy Tính Bảng,3690000,2350000,332,4.7,1340000,36
iPad Air 10.9 Wi-Fi 64GB New 2020 - Hàng Chính Hãng,Điện Thoại - Máy Tính Bảng,17990000,14950000,124,4.8,3040000,17
Điện Thoại Oppo A93 2020 (8GB/128GB) - Hàng Chính Hãng,Điện Thoại - Máy Tính Bảng,7490000,5590000,108,4.8,1900000,25
Điện Thoại Di Động Forme L6 Hồng - Hàng Chính Hãng,Điện Thoại - Máy Tính Bảng,349000,345000,16,4.5,4000,1
Điện Thoại Vsmart Star 5 (3GB/32GB) - Hàng Chính Hãng,Điện Thoại - Máy Tính Bảng,2690000,2290000,19,4.7,400000,15
Điện Thoại Samsung Galaxy A12 (4GB/128GB) - Hàng Chính Hãng,Điện Thoại - Máy Tính Bảng,4290000,3750000,54,4.8,540000,13
Điện Thoại Nokia 3.4 - Hàng Chính Hãng,Điện Thoại - Máy Tính Bảng,3690000,2229700,56,4.5,1460300,40
"Điện thoại Forme D10, MÀN HÌNH 2.0inch, CHỨC NĂNG GỌI KHẨN CẤP SOS, LOA TO, FONT CHỮ LỚN, PHÍM SỐ LỚN, FM KHÔNG DÂY - Hàng chính hãng",Điện Thoại - Máy Tính Bảng,345000,335000,3,5,10000,3
Điện Thoại Xiaomi POCO X3 NFC (6GB/128GB) - Hàng Chính Hãng,Điện Thoại - Máy Tính Bảng,6990000,5379000,0,0,1611000,23
Điện Thoại Samsung Galaxy S21 Ultra 5G (12GB/128GB) - Hàng Chính Hãng,Điện Thoại - Máy Tính Bảng,30990000,21620000,0,0,9370000,30
Điện Thoại Samsung Galaxy S21 Plus 5G (8GB/128GB) - Hàng Chính Hãng,Điện Thoại - Máy Tính Bảng,25990000,16990000,0,0,9000000,35
Điện Thoại Di Động Forme A5 - Hãng phân phối chính hãng,Điện Thoại - Máy Tính Bảng,389000,335000,4,4,54000,14
Máy đọc sách Kindle Oasis 3 (2019) - Amazon - Hàng nhập khẩu,Điện Thoại - Máy Tính Bảng,9000000,6456600,131,4.7,2543400,28
Điện thoại Vsmart Star 4 (4GB/64GB) - Hàng Chính Hãng,Điện Thoại - Máy Tính Bảng,2690000,2190000,7,5,500000,19
Điện Thoại iPhone 11 64GB  - Hàng Nhập Khẩu,Điện Thoại - Máy Tính Bảng,22990000,16100000,62,4.7,6890000,30
Điện Thoại Di Động Forme L6  - Hàng Chính Hãng,Điện Thoại - Máy Tính Bảng,349000,345000,8,3.9,4000,1
Điện Thoại iPhone 12 Pro 256GB - Hàng Chính Hãng,Điện Thoại - Máy Tính Bảng,34990000,28990000,96,4.8,6000000,17
Điện thoại Vivo Y1S - Hàng chính hãng,Điện Thoại - Máy Tính Bảng,2690000,2040000,26,4.8,650000,24
Điện thoại Vsmart Aris (8GB/128GB) - Hàng Chính Hãng,Điện Thoại - Máy Tính Bảng,7490000,5249900,94,4.7,2240100,30
Điện Thoại Di Động Forme F1 Black Golden - Hàng Chính Hãng,Điện Thoại - Máy Tính Bảng,299000,275000,4,4.5,24000,8
Máy đọc sách Kindle PaperWhite Gen 4 (10th) - Bản 8GB - Hàng chính hãng,Điện Thoại - Máy Tính Bảng,3990000,2930000,478,4.6,1060000,27
Điện Thoại Oppo Reno 5 (8GB/128G) - Hàng Chính Hãng,Điện Thoại - Máy Tính Bảng,8990000,7250000,27,4.8,1740000,19
iPad Pro 11 inch (2020) 128GB Wifi  - Hàng  Chính Hãng,Điện Thoại - Máy Tính Bảng,21990000,20450000,36,5,1540000,7
Điện Thoại Di Động Forme Gorilla Coffee - Hàng Chính Hãng,Điện Thoại - Máy Tính Bảng,359000,299000,4,3.8,60000,17
Điện Thoại Vsmart Star 4 (2GB/16GB) - Hàng Chính Hãng,Điện Thoại - Máy Tính Bảng,1850000,1799000,56,4.6,51000,3
Máy Tính Bảng Samsung Galaxy Tab S7 Plus T975 (6GB/128GB) - ĐÃ KÍCH HOẠT BẢO HÀNH ĐIỆN TỬ - Hàng Chính Hãng,Điện Thoại - Máy Tính Bảng,23990000,16990000,13,5,7000000,29
Điện Thoại Vsmart Active 3 - Hàng Chính Hãng,Điện Thoại - Máy Tính Bảng,4990000,3190000,17,4.5,1800000,36
Điện Thoại Di Động Forme D555+ - Hàng Chính Hãng,Điện Thoại - Máy Tính Bảng,339000,290000,4,4,49000,14
Điện Thoại Samsung Galaxy A12 (4GB/128GB) - ĐÃ KÍCH HOẠT BẢO HÀNH ĐIỆN TỬ - Hàng Chính Hãng,Điện Thoại - Máy Tính Bảng,4290000,3575000,0,0,715000,17
Điện Thoại Oppo A73 2020 (6GB/128GB) - Hàng Chính Hãng,Điện Thoại - Máy Tính Bảng,5490000,4812800,540,4.8,677200,12
"Điện thoại Forme Duos 1900, màn hình 2.8inch, pin 1900mAh, font chữ lớn - Phân phối chính hãng",Điện Thoại - Máy Tính Bảng,360000,310000,15,4.6,50000,14
Điện Thoại Xiaomi Redmi Note 10 Pro (6GB/128GB) - Hàng Chính Hãng,Điện Thoại - Máy Tính Bảng,6990000,6690000,1,5,300000,4
Điện Thoại Xiaomi Redmi 9 - Hàng Chính Hãng,Điện Thoại - Máy Tính Bảng,3590000,2890000,95,5,700000,19
Điện Thoại iPhone 12 128GB - Hàng Chính Hãng,Điện Thoại - Máy Tính Bảng,26990000,25990000,0,0,1000000,4
Điện Thoại Di Động Forme Gorilla  - Hàng Chính Hãng,Điện Thoại - Máy Tính Bảng,359000,299000,8,4.5,60000,17
Điện Thoại OPPO RENO 3 Pro (8GB/256GB) - Hàng Chính Hãng,Điện Thoại - Máy Tính Bảng,14990000,6450000,46,4.8,8540000,57
Điện Thoại Samsung Galaxy Note 20 (8GB/256GB) - ĐÃ KÍCH HOẠT BẢO HÀNH ĐIỆN TỬ - Hàng Chính Hãng,Điện Thoại - Máy Tính Bảng,23990000,15790000,48,4.8,8200000,34
Điện Thoại Samsung Galaxy A72 (8GB/256GB) - Hàng Chính Hãng,Điện Thoại - Máy Tính Bảng,11490000,10700000,0,0,790000,7
"Điện thoại Forme D10, MÀN HÌNH 2.0inch, CHỨC NĂNG GỌI KHẨN CẤP SOS, LOA TO, FONT CHỮ LỚN, PHÍM SỐ LỚN, FM KHÔNG DÂY - Hàng chính hãng",Điện Thoại - Máy Tính Bảng,345000,335000,3,5,10000,3
Máy Đọc Sách Kindle Paperwhite Gen 10 - Hàng Nhập Khẩu,Điện Thoại - Máy Tính Bảng,4300000,2950000,213,4.8,1350000,31
Máy Tính Bảng Samsung Galaxy Tab A8 8 T295 - Hàng Chính Hãng,Điện Thoại - Máy Tính Bảng,3690000,3490000,8,4,200000,5
Máy Tính Bảng Samsung Galaxy Tab A7 (3GB/64GB) SM-T505 ĐÃ KÍCH HOẠT BẢO HÀNH ĐIỆN TỬ - Hàng Chính Hãng,Điện Thoại - Máy Tính Bảng,7990000,5990000,7,5,2000000,25
Điện Thoại Di Động Forme A5 - Hãng phân phối chính hãng,Điện Thoại - Máy Tính Bảng,389000,335000,4,4,54000,14
Điện Thoại iPhone 11 128GB  - Hàng Nhập Khẩu,Điện Thoại - Máy Tính Bảng,24990000,17900000,36,4.8,7090000,28
Điện thoại Xiaomi Redmi Note 10 (4GB/64GB) - Hàng chính hãng,Điện Thoại - Máy Tính Bảng,4690000,4050000,1,5,640000,14
Điện thoại Xiaomi POCO X3 - Hàng Chính Hãng ,Điện Thoại - Máy Tính Bảng,6690000,4990000,4,4.8,1700000,25
Điện Thoại Di Động Forme F1 Black Golden - Hàng Chính Hãng,Điện Thoại - Máy Tính Bảng,299000,275000,4,4.5,24000,8
Điện Thoại Vsmart Joy 3 - Hàng chính hãng,Điện Thoại - Máy Tính Bảng,3290000,2790000,0,0,500000,15
Điện Thoại Realme C15 (4GB/64G) - Hàng Chính Hãng,Điện Thoại - Máy Tính Bảng,4190000,3390000,0,0,800000,19
Điện Thoại iPhone 11 Pro 64GB - Hàng Nhập Khẩu ,Điện Thoại - Máy Tính Bảng,32990000,21650000,10,4.8,11340000,34
Điện Thoại Di Động Forme Gorilla Coffee - Hàng Chính Hãng,Điện Thoại - Máy Tính Bảng,359000,299000,4,3.8,60000,17
Điện Thoại Oppo A91 (8GB/128G) - Hàng Chính Hãng,Điện Thoại - Máy Tính Bảng,6990000,4990000,85,4.5,2000000,29
Điện Thoại Oppo A12 (4GB/64GB) - Hàng Chính Hãng,Điện Thoại - Máy Tính Bảng,3990000,2950000,45,4.7,1040000,26
"Điện thoại Forme A77 màn hình 5inch, Wifi, 3G, 2 sim  - Hàng chính hãng",Điện Thoại - Máy Tính Bảng,990000,729000,67,3.7,261000,26
Điện Thoại Di Động Forme L6  - Hàng Chính Hãng,Điện Thoại - Máy Tính Bảng,349000,345000,8,3.9,4000,1
Điện Thoại Nokia 150 (2020) -  Hàng Chính Hãng,Điện Thoại - Máy Tính Bảng,660000,609000,3,4.7,51000,8
iPad 10.2 Inch WiFi/Cellular 32GB New 2019 - Hàng Nhập Khẩu Chính Hãng,Điện Thoại - Máy Tính Bảng,11990000,9990000,36,4.8,2000000,17
Điện Thoại Xiaomi Redmi 9C - Hàng Chính Hãng,Điện Thoại - Máy Tính Bảng,2490000,2490000,42,5,0,0
Điện Thoại Di Động Forme D555+ - Hàng Chính Hãng,Điện Thoại - Máy Tính Bảng,339000,290000,4,4,49000,14
Điện Thoại OPPO Reno 2 (8GB/256GB) - Hàng Chính Hãng,Điện Thoại - Máy Tính Bảng,14990000,7700000,20,5,7290000,49
Điện Thoại iPhone 12 Mini 128GB - Hàng Chính Hãng,Điện Thoại - Máy Tính Bảng,23990000,19700000,2,4.5,4290000,18
Điện Thoại Samsung Galaxy A11 (32GB/3GB) - Hàng Chính Hãng - (Đã kích hoạt bảo hành điện tử),Điện Thoại - Máy Tính Bảng,3690000,2650000,95,4.7,1040000,28
Máy đọc sách All New Kindle Bản đặc biệt 8GB - Hàng nhập khẩu,Điện Thoại - Máy Tính Bảng,3190000,2215000,39,4.7,975000,31
Điện thoại Vivo Y12s - Hàng Chính Hãng,Điện Thoại - Máy Tính Bảng,3290000,2640000,0,0,650000,20
Điện Thoại Nokia 2.4 (2GB/32GB) - Hàng Chính Hãng,Điện Thoại - Máy Tính Bảng,2690000,2030000,2,5,660000,25
Điện Thoại Samsung Galaxy Note 20 Ultra 5G (12GB/256GB) - ĐÃ KÍCH HOẠT BẢO HÀNH ĐIỆN TỬ - Hàng Chính Hãng,Điện Thoại - Máy Tính Bảng,33000000,21450000,0,0,11550000,35
Điện thoại Xiaomi Redmi Note 9S - Hàng Chính Hãng,Điện Thoại - Máy Tính Bảng,5490000,4750000,4,5,740000,13
Điện Thoại Nokia 5.4 (4GB/128GB) - Hàng Chính Hãng,Điện Thoại - Máy Tính Bảng,4990000,3580000,1,5,1410000,28
iPad 10.2 Inch WiFi 128GB (gen 8) New 2020 - Hàng Chính Hãng,Điện Thoại - Máy Tính Bảng,14990000,10950000,122,4.8,4040000,27
Điện Thoại Samsung Galaxy Note 20 Ultra (8GB/256GB) - ĐÃ KÍCH HOẠT BẢO HÀNH ĐIỆN TỬ - Hàng Chính Hãng,Điện Thoại - Máy Tính Bảng,29990000,20090000,5,4.6,9900000,33
Điện thoại Xiaomi Redmi Note 10 (6GB/128GB) - Hàng chính hãng - Xám,Điện Thoại - Máy Tính Bảng,5490000,4779000,0,0,711000,13
Điện Thoại OPPO RENO 4 (8GB/128GB) - Hàng Chính Hãng,Điện Thoại - Máy Tính Bảng,8990000,6350000,87,4.8,2640000,29
Điện Thoại Xiaomi Mi 10T Pro 5G - Hàng Chính Hãng,Điện Thoại - Máy Tính Bảng,11990000,10299000,0,0,1691000,14
Điện thoại Vsmart Star 4 (3GB/32GB) - Hàng Chính Hãng,Điện Thoại - Máy Tính Bảng,2290000,2090000,25,4.8,200000,9
Điện Thoại OPPO A9 2020 (8GB/128GB) - Hàng Chính Hãng,Điện Thoại - Máy Tính Bảng,7990000,4699000,87,4.6,3291000,41
Điện Thoại Xiaomi Redmi Note 10 Pro (8GB/128GB) - Hàng Chính Hãng,Điện Thoại - Máy Tính Bảng,7490000,6793800,5,5,696200,9
Điện Thoại Samsung Galaxy S21 Ultra 5G (12GB/128GB) - ĐÃ KÍCH HOẠT BẢO HÀNH ĐIỆN TỬ -  Hàng Chính Hãng ,Điện Thoại - Máy Tính Bảng,30990000,21450000,0,0,9540000,31
Điện Thoại iPhone 12 Pro Max 512GB - Hàng Chính Hãng,Điện Thoại - Máy Tính Bảng,43990000,36990000,34,4.7,7000000,16
Điện Thoại Nokia 6300 4G - Hàng Chính Hãng,Điện Thoại - Máy Tính Bảng,1290000,1139000,71,4.5,151000,12
Điện Thoại Realme C12 (3GB/32GB) - Hàng Chính Hãng,Điện Thoại - Máy Tính Bảng,3490000,2899000,1,5,591000,17
Điện Thoại Realme 6I (4GB/128GB) - Hàng Chính Hãng ,Điện Thoại - Máy Tính Bảng,4990000,3850000,33,4.8,1140000,23
iPad Air 10.9 Wi-Fi 256GB New 2020 - Hàng Chính Hãng,Điện Thoại - Máy Tính Bảng,21990000,18600000,58,4.8,3390000,15
Điện Thoại Samsung Galaxy A31 (6GB/128GB) - ĐÃ KÍCH HOẠT BẢO HÀNH ĐIỆN TỬ - Hàng Chính Hãng,Điện Thoại - Máy Tính Bảng,6490000,4855000,8,5,1635000,25
Điện Thoại Vivo Y20 (4GB/64GB) - Hàng Chính Hãng,Điện Thoại - Máy Tính Bảng,3990000,3150000,2,5,840000,21
Điện Thoại Samsung Galaxy A52 (8GB/128GB) - Hàng Chính Hãng,Điện Thoại - Máy Tính Bảng,9290000,8641000,0,0,649000,7
Điện thoại Xiaomi Redmi Note 9 (4GB/128GB) - Hàng chính hãng,Điện Thoại - Máy Tính Bảng,4990000,4290000,17,4.8,700000,14
Điện Thoại iPhone 12 Pro 512GB - Hàng Chính Hãng,Điện Thoại - Máy Tính Bảng,40990000,31990000,15,5,9000000,22
Điện Thoại Oppo A31 2020 (6GB/128GB) - Hàng Chính Hãng,Điện Thoại - Máy Tính Bảng,5290000,3950000,40,4.5,1340000,25
iPad Pro 11 inch (2020) 128GB Wifi Cellular  - Hàng  Chính Hãng,Điện Thoại - Máy Tính Bảng,26990000,23990000,5,4.8,3000000,11
Máy Đọc Sách All New Kindle 2019 (10th) – Hàng Chính Hãng,Điện Thoại - Máy Tính Bảng,2999000,2299000,68,4.8,700000,23
Điện thoại Mobell C106 - Hàng chính hãng,Điện Thoại - Máy Tính Bảng,199000,149000,44,4.8,50000,25
Điện Thoại Samsung Galaxy A51 (6GB/128GB) - ĐÃ KÍCH HOẠT BẢO HÀNH ĐIỆN TỬ - Hàng Chính Hãng,Điện Thoại - Máy Tính Bảng,7990000,6080000,4,5,1910000,24
Điện thoại Vsmart Aris Pro (8GB/128GB) - Hàng chính hãng,Điện Thoại - Máy Tính Bảng,9990000,6741000,1,5,3249000,33
Điện Thoại Oppo A15 (3GB/32G) - Hàng Chính Hãng,Điện Thoại - Máy Tính Bảng,3490000,3190000,9,5,300000,9
Điện Thoại Nokia 215 4G - Hàng Chính Hãng,Điện Thoại - Máy Tính Bảng,749000,640000,0,0,109000,15
Điện thoại Xiaomi Redmi Note 10 Pro (8GB/128GB) - Hàng chính hãng - Xám,Điện Thoại - Máy Tính Bảng,7490000,7090000,2,5,400000,5
Điện Thoại Samsung Galaxy A12 (4GB/128GB) - Đã kích hoạt bảo hành điện tử-Hàng Chính Hãng - Đen,Điện Thoại - Máy Tính Bảng,4190000,3575000,4,4.5,615000,15
Điện Thoại Samsung Galaxy A21s - ĐÃ KÍCH HOẠT BẢO HÀNH ĐIỆN TỬ - Hàng Chính Hãng,Điện Thoại - Máy Tính Bảng,4690000,3590000,5,5,1100000,23
Máy Tính Bảng Masstel Tab 10 Pro - Hàng Chính Hãng,Điện Thoại - Máy Tính Bảng,2790000,2090000,14,4,700000,25
Điện Thoại Xiaomi Redmi 9T - Hàng Chính Hãng,Điện Thoại - Máy Tính Bảng,3990000,3650000,3,3.7,340000,9
Điện Thoại Di Động GSM ZONO N8110 2.4inch – Hàng Nhập Khẩu - Vàng,Điện Thoại - Máy Tính Bảng,350000,209000,33,4.5,141000,40
Điện Thoại Nokia 210 - Hàng Chính Hãng,Điện Thoại - Máy Tính Bảng,779000,779000,1,5,0,0
Máy đọc sách Onyx Boox Poke 3 - Hàng Chính Hãng,Điện Thoại - Máy Tính Bảng,5990000,5000000,11,5,990000,17
Điện Thoại iPhone 12 Mini 256GB - Hàng Chính Hãng,Điện Thoại - Máy Tính Bảng,25990000,23000000,1,5,2990000,12
Máy Tính Bảng Samsung Galaxy Tab S6 Lite (SM-P615N) - Hàng Chính Hãng,Điện Thoại - Máy Tính Bảng,9990000,8550000,9,5,1440000,14
Điện Thoại Di Động GSM ZONO N8110 1.8inch – Hàng Nhập Khẩu,Điện Thoại - Máy Tính Bảng,330000,149000,68,3.9,181000,55
iPad Air 10.5 Wi-Fi 256GB New 2019 - Hàng Chính Hãng,Điện Thoại - Máy Tính Bảng,16990000,14990000,7,5,2000000,12
Điện thoại Vsmart Joy 4 (4GB/64GB)- Hàng chính hãng-màu xanh ngọc lam,Điện Thoại - Máy Tính Bảng,3590000,3270000,7,5,320000,9
Máy Tính Bảng Mobell Tab 7S (8GB) - Hàng Chính Hãng,Điện Thoại - Máy Tính Bảng,1990000,979000,10,4.7,1011000,51
Điện Thoại iPhone SE 64GB ( 2020) - Hàng NHập Khẩu,Điện Thoại - Máy Tính Bảng,12990000,9990000,53,4.5,3000000,23
"Điện thoại itel it2161 (Ace) - FM không dây, đèn pin cỡ lớn, 2 sim, danh bạ 1000 số - Hàng chính hãng",Điện Thoại - Máy Tính Bảng,250000,165000,21,4.7,85000,34
Điện thoại Xiaomi Redmi Note 9 Pro - Hàng Chính Hãng,Điện Thoại - Máy Tính Bảng,6990000,5790000,1,5,1200000,17
Điện Thoại Realme C17 (6GB/128GB) - Hàng Chính Hãng,Điện Thoại - Máy Tính Bảng,5290000,4790000,4,5,500000,9
Máy Tính Bảng Masstel Tab 10 4G - Hàng Chính Hãng,Điện Thoại - Máy Tính Bảng,3190000,2990000,0,0,200000,6
Máy Tính Bảng Samsung Galaxy Tab A8 8 T295 - Đã Kích Hoạt Bảo Hành - Hàng Chính Hãng,Điện Thoại - Máy Tính Bảng,3690000,3190000,5,5,500000,14
Máy tính bảng HUAWEI MatePad T 10s - Hàng Phân Phối Chính Hãng,Điện Thoại - Máy Tính Bảng,5490000,5290000,3,5,200000,4
Điện Thoại Vivo Y20s (6GB/128GB) - Hàng Chính Hãng,Điện Thoại - Máy Tính Bảng,4990000,4390000,0,0,600000,12
Điện thoại Samsung Galaxy A32-Hàng Chính Hãng,Điện Thoại - Máy Tính Bảng,6690000,5779000,0,0,911000,14
Máy TÍnh Bảng HUAWEI Matepad T8 2G/32G- Thẻ nhớ ngoài 512GB - Hàng Chính Hãng,Điện Thoại - Máy Tính Bảng,3290000,2990000,7,5,300000,9
Điện thoại Nokia 105- Dual sim (2 sim)- Hàng chính hãng,Điện Thoại - Máy Tính Bảng,360000,335000,4,4.3,25000,7
Điện thoại Energizer Power Max P20 kiêm sạc dự phòng - Hàng chính hãng,Điện Thoại - Máy Tính Bảng,800000,499000,23,4.1,301000,38
Combo Máy Đọc Sách Kindle Paperwhite 4 Gen 10 (8GB - Màu Đen - Hàng nhập khẩu) và Bao Da WELL BEGUN,Điện Thoại - Máy Tính Bảng,4990000,3180000,18,4.3,1810000,36
Điện thoại Samsung E1200 - Hàng Chính Hãng ,Điện Thoại - Máy Tính Bảng,347000,347000,40,4.7,0,0
Combo Máy Đọc Sách Kindle Paperwhite Gen 10 (8GB - Màu Đen) và Bao da WELL BEGUN - Hàng nhập khẩu,Điện Thoại - Máy Tính Bảng,4290000,3145000,35,4.8,1145000,27
Điện thoại Energizer E12 - Hàng Chính Hãng,Điện Thoại - Máy Tính Bảng,500000,237000,56,4.1,263000,53
Điện thoại Masstel IZI 230,Điện Thoại - Máy Tính Bảng,350000,275000,41,4.5,75000,21
iPad Pro 12.9 inch (2020) Wifi - Hàng Nhập Khẩu,Điện Thoại - Máy Tính Bảng,27990000,24299000,16,4.5,3691000,13
Điện thoại Realme C20 (2GB/32GB)- Hàng chính hãng,Điện Thoại - Máy Tính Bảng,2690000,2290000,4,5,400000,15
Máy tính bảng Kindle Fire HD8 Model 2020 - 32GB - Hàng nhập khẩu,Điện Thoại - Máy Tính Bảng,3990000,1990000,3,5,2000000,50
Điện Thoại Samsung Galaxy A02s (4GB/64GB) - Hàng Chính Hãng,Điện Thoại - Máy Tính Bảng,4190000,2990000,0,0,1200000,29
Điện thoại Vsmart Aris (6GB/64GB) - Hàng Chính Hãng,Điện Thoại - Máy Tính Bảng,6990000,5399000,0,0,1591000,23
iPad 10.2 Inch WiFi + Cellular 32GB (Gen 8) New 2020 - Hàng Chính Hãng,Điện Thoại - Máy Tính Bảng,15990000,11850000,18,4.7,4140000,26
Điện Thoại Nokia 5310 (2020) - Hàng Chính Hãng,Điện Thoại - Máy Tính Bảng,990000,919000,6,4.5,71000,7
ĐIỆN THOẠI VIVO Y12S- HÀNG CHÍNH HÃNG,Điện Thoại - Máy Tính Bảng,2990000,2790000,0,0,200000,7
Nồi chiên không dầu Philips HD9252/90 - Hàng chính hãng,Đồ dùng nhà bếp,3200000,2589900,258,4.8,610100,19
Máy Xay Sinh Tố Cầm Tay Lock&Lock EJJ321 (50W - 300ml) - Hàng Chính Hãng,Đồ dùng nhà bếp,1460000,795000,43,4.1,665000,46
Nồi Chiên Không Dầu Điện Tử Lock&Lock EJF357BLK (5.2 Lít) - Hàng Chính Hãng,Đồ dùng nhà bếp,5060000,2615000,75,4.8,2445000,48
Máy Vắt Cam Lock&Lock EJJ231 (700ml) - Hàng chính hãng,Đồ dùng nhà bếp,422000,239000,189,4.6,183000,43
Nồi Chiên Không Dầu Điện Tử Philips HD9650/91 XXL (1.4kg) - Hàng Chính Hãng,Đồ dùng nhà bếp,8490000,6187300,445,4.5,2302700,27
Nồi Cơm Điện Mini Lock&Lock EJR426 Dung Tích 0.8 lít  (Hàng chính hãng),Đồ dùng nhà bếp,950000,539000,264,4.7,411000,43
Ấm Điện Thủy Tinh Siêu Tốc Có Điều Chỉnh Nhiệt Độ Lock&Lock EJK341 (1.8L) - Hàng chính hãng,Đồ dùng nhà bếp,1070000,590000,71,4.7,480000,45
Máy Xay Thịt 2 Lưỡi Dao Kép Lock&Lock EJM171 (2L) - Hàng Chính Hãng,Đồ dùng nhà bếp,1340000,709000,49,4.6,631000,47
Máy Xay Thực Phẩm (3 Cối) LOTOR HC-302D - Hàng Chính Hãng,Đồ dùng nhà bếp,1280000,590000,0,0,690000,54
Ấm Siêu Tốc Inox SUNHOUSE HAPPY TIME HTD1055 (1.5L) - Hàng Chính Hãng,Đồ dùng nhà bếp,213000,99000,916,4.5,114000,54
Máy xay sinh tố Philips HR2223/00 - Hàng Chính Hãng,Đồ dùng nhà bếp,1900000,1458200,215,4.5,441800,23
Nồi Chiên Không Dầu Philips HD9220/20 (2.4L) - Hàng chính hãng,Đồ dùng nhà bếp,4999000,2026000,84,4.7,2973000,59
Máy xay sinh tố Philips HR2222/00 - Hàng Chính Hãng,Đồ dùng nhà bếp,1650000,1208700,55,4.6,441300,27
Nồi Cơm Điện Tử Toshiba RC-10NMFVN (WT) (1 Lít) - Hàng Chính Hãng,Đồ dùng nhà bếp,2190000,1658900,844,4.7,531100,24
Bình Đun Siêu Tốc 2 lớp Lock&Lock EJK738WHT (1.7L) - Trắng - Hàng chính hãng,Đồ dùng nhà bếp,745000,419000,60,4.6,326000,44
Lò Vi Sóng Sharp R-205VN(S) - 20L - Hàng chính hãng,Đồ dùng nhà bếp,1700000,1369000,12,5,331000,19
Nồi Chiên Không Dầu Philips HD9218 (1425W) - Hàng Chính Hãng,Đồ dùng nhà bếp,4200000,2869600,34,4.7,1330400,32
Nồi cơm điện tử Tefal RK733168 - Hàng chính hãng,Đồ dùng nhà bếp,1429000,1119000,59,4.5,310000,22
Máy Xay Sinh Tố Mini Hafele GS-621 (350W) - Hàng Chính Hãng,Đồ dùng nhà bếp,890000,554000,355,4.7,336000,38
Máy xay sinh tố Tefal BL967B66 - Hàng chính hãng,Đồ dùng nhà bếp,4762000,3199000,40,4.5,1563000,33
Bếp Gas Âm 2 Vùng Nấu Hafele HC-G783B (78cm) - Hàng Chính Hãng,Đồ dùng nhà bếp,5990000,4347300,17,4.6,1642700,27
Nồi áp suất điện đa năng Tefal CY601868 - Hàng chính hãng,Đồ dùng nhà bếp,3289000,2329000,40,4.5,960000,29
Nồi Chiên Không Dầu Điện Tử Lock&Lock EJF296BLK (7.2 Lít) - Kèm Chảo Nướng - Hàng Chính Hãng,Đồ dùng nhà bếp,5460000,3249000,1,3,2211000,40
Máy Xay Sinh Tố Đa Năng Cao Cấp 2 Tầng Lưỡi Nắp Bẹt Màu Nâu Tiện Dụng,Đồ dùng nhà bếp,450000,142200,6,3.7,307800,68
Nồi Chiên Chân Không Điện Tử Ranee RN-AF10LH (10L) kèm bộ phụ kiện 9 món - Hàng chính hãng,Đồ dùng nhà bếp,2989000,1999000,16,4.5,990000,33
Máy Ép Chậm SnapBee SK-202VN - Hàng chính hãng,Đồ dùng nhà bếp,1950000,1736000,71,4.2,214000,11
Nồi Chiên Không Dầu Lock&Lock EJF357WHT (5.2 Lít) - Hàng Chính Hãng,Đồ dùng nhà bếp,5060000,2609000,6,4.7,2451000,48
Bình Đun Siêu Tốc 2 Lớp Lock&Lock EJK738BLK (1.7L) - Hàng Chính Hãng,Đồ dùng nhà bếp,745000,669000,399,4.6,76000,10
Nồi Chiên Không Dầu Điện Tử Philips 6.2L HD9270/90 (1.2kg) - Hàng Chính Hãng,Đồ dùng nhà bếp,5490000,3890000,1,5,1600000,29
Nồi chiên không dầu Tefal - EY401D15 - Hàng chính hãng,Đồ dùng nhà bếp,5399000,3099000,40,4.6,2300000,43
Máy Hấp Thực Phẩm Magic Korea A64 (500W) - Hàng chính hãng,Đồ dùng nhà bếp,499000,328900,887,4.5,170100,34
"Nồi Chiên Không Dầu Điện Tử BlueStone AFB-5869 (3,2 Lít) - Hàng Chính Hãng",Đồ dùng nhà bếp,2799000,1399000,125,5,1400000,50
Lò Vi Sóng Có Nướng Electrolux EMS2027GX (20 lít) – Đen - Hàng chính hãng,Đồ dùng nhà bếp,2990000,1890000,0,0,1100000,37
Bếp Điện Từ Sunhouse SHD6800 - Tặng Kèm Nồi Lẩu - Hàng chính hãng,Đồ dùng nhà bếp,1050000,688900,2,4.5,361100,34
Ấm Siêu Tốc Nagakawa NAG0313 (1.8 Lít) - Hàng Chính Hãng,Đồ dùng nhà bếp,190000,109000,361,4.5,81000,43
Máy ép trái cây hoa quả tốc độ chậm SAVTM JE-07 - hàng nhập khẩu,Đồ dùng nhà bếp,990000,686000,141,4.1,304000,31
Bếp Âm Từ Đôi Hafele HC-IS772EA (76 cm) - Hàng chính hãng,Đồ dùng nhà bếp,18990000,15292000,0,0,3698000,19
Máy Ép Trái Cây Panasonic PAVH-MJ-68MWRA - 600 ML - Hàng Chính Hãng,Đồ dùng nhà bếp,1577000,1252400,352,4.6,324600,21
Máy Pha Cà Phê Espresso Tiross TS-621 - Hàng Chính Hãng,Đồ dùng nhà bếp,1490000,956000,655,4.5,534000,36
Máy Làm Sữa Hạt Đa Năng Bluestone SMB-7329 (1.3 Lít) - Hàng Chính Hãng ,Đồ dùng nhà bếp,1999000,1498900,612,4.6,500100,25
Bếp Điện Từ TrueHome TI-20TS1(P) - Hàng Chính Hãng,Đồ dùng nhà bếp,1190000,840000,1,5,350000,29
Nồi Chiên Không Dầu Điện Tử Bluestone AFB-5873 (5.5 Lít) - Hàng Chính Hãng,Đồ dùng nhà bếp,3699000,1999000,758,4.5,1700000,46
Máy Vắt Cam Hafele GS-401 - Hàng Chính Hãng,Đồ dùng nhà bếp,1090000,659000,569,4.7,431000,40
Máy Xay Sinh Tố Electrolux EBR3416 - Xanh - Hàng Chính Hãng,Đồ dùng nhà bếp,790000,499000,230,4.5,291000,37
Nồi Chiên Không Dầu Hafele AF-602A 11 Lít – Hàng Chính Hãng,Đồ dùng nhà bếp,4990000,3499000,5,4.8,1491000,30
Nồi Chiên Không Dầu Bluestone AFB-5870 (5L) - Hàng Chính Hãng,Đồ dùng nhà bếp,2999000,1799000,652,4.6,1200000,40
Bếp Điện Từ Electrolux ETD29KC - Đen (Kèm Nồi Lẩu) - Hàng chính hãng,Đồ dùng nhà bếp,1190000,993000,581,4.7,197000,17
Ấm Đun Siêu Tốc LOCK EJK418SLV -Hàng Chính Hãng,Đồ dùng nhà bếp,925000,409000,32,4.7,516000,56
"Máy Hút Chân Không Thực Phẩm Hút Được Nước, Không  Kén Túi, Hút Được Mọi Loại Túi VC-ECO - Hàng chính hãng SGE Thailand. Phù hợp cho gia đình, hộ kinh doanh. Được tặng kèm máy 10 túi hút chân không mặt trơn.",Đồ dùng nhà bếp,2750000,2050000,15,3.7,700000,25
Máy Ép Trái Cây Philips HR1811 - Trắng Xanh - Hàng Nhập Khẩu,Đồ dùng nhà bếp,1390000,999000,26,4.7,391000,28
Máy Đánh Trứng Bluestone HMB-6333S (300W) - Hàng chính hãng,Đồ dùng nhà bếp,799000,588900,739,4.7,210100,26
Bếp hồng ngoại cơ Sunhouse SHD6004 - Hàng chính hãng,Đồ dùng nhà bếp,699000,440000,146,4.7,259000,37
Máy Xay Sinh Tố 2 Ly Morphy Richards (300W) MR9500 - Xanh - Hàng Chính Hãng,Đồ dùng nhà bếp,1300000,1059000,6,4.2,241000,19
Nồi Hầm Cháo Cách Thủy 2 Tầng 2GOOD A600 (1.5L) - Hàng Chính Hãng,Đồ dùng nhà bếp,950000,634000,74,4.5,316000,33
Nồi Chiên Không Dầu FAF4.0M 4L,Đồ dùng nhà bếp,1199000,699000,102,4.6,500000,42
Máy Đánh Trứng Cầm Tay 7 Tốc Độ Công Suất Lớn Tặng Kèm 4 Que Đánh Cao Cấp Thép Không Gỉ - Hàng Chính Hãng - Hàng Nhập Khẩu,Đồ dùng nhà bếp,300000,159000,110,4.5,141000,47
"Bình Đun Nước Và Giữ Nhiệt Đa Chức Năng, Điều Chỉnh Nhiệt Độ, Làm Mát Nhanh - Hàng Nhập Khẩu",Đồ dùng nhà bếp,2284000,1799000,1,5,485000,21
Máy xay cầm tay Braun MQ5235 - Hàng Chính Hãng,Đồ dùng nhà bếp,2090000,1549000,21,5,541000,26
Nồi Chiên Không Dầu Bluestone AFB-5859 - 3.3L - Hàng chính hãng,Đồ dùng nhà bếp,2499000,1195000,525,4.5,1304000,52
Máy Ép Trái Cây Hafele GS-353 400W (1.4L) - Hàng Chính Hãng,Đồ dùng nhà bếp,1490000,939000,66,4.5,551000,37
 Máy Xay Thịt 2 Lưỡi Kép Bluestone CHB-5139 (2L) - Hàng chính hãng,Đồ dùng nhà bếp,1199000,898900,920,4.6,300100,25
"Máy Hút Chân Không Thực Phẩm Hút Được Nước, Không  Kén Túi, Hút Được Mọi Loại Túi VC-ECO - Hàng chính hãng SGE Thailand. Phù hợp cho gia đình, hộ kinh doanh. Được tặng kèm máy 10 túi hút chân không mặt trơn.",Đồ dùng nhà bếp,2750000,2050000,15,3.7,700000,25
Nồi Điện Đa Năng Lock&Lock EJP116BLK (0.8 Lít) - Hàng Chính Hãng,Đồ dùng nhà bếp,830000,465000,30,4.5,365000,44
Máy Vắt Cam Philips HR-2738 - Hàng chính hãng,Đồ dùng nhà bếp,659000,413300,762,4.7,245700,37
Máy Xay Thịt 4 Lưỡi - Dung Tích 2 Lít - Công Suất 300W,Đồ dùng nhà bếp,1105000,254900,26,3.7,850100,77
Máy Sấy Thực Phẩm Thế Hệ Mới GE Black 6 khay - Hàng Thailand chính hãng,Đồ dùng nhà bếp,5000000,3800000,15,4.5,1200000,24
Máy xay sinh tố mini cầm tay 2 lưỡi Osaka dùng để xay thịt xay hoa quả xay cháo cho bé yêu đa năng tiện dụng nhỏ gọn,Đồ dùng nhà bếp,299000,141000,1,5,158000,53
Máy Ép Chậm Trái Cây Elmich JEE-1853 hàng chính hãng,Đồ dùng nhà bếp,3590000,2839500,4,4.8,750500,21
Nồi cơm điện từ Tefal RK732168 1.8L - 750W - Hàng chính hãng,Đồ dùng nhà bếp,1429000,990000,0,0,439000,31
"Bình Đun Nước Và Giữ Nhiệt Đa Chức Năng, Điều Chỉnh Nhiệt Độ, Làm Mát Nhanh - Hàng Nhập Khẩu",Đồ dùng nhà bếp,2284000,1799000,1,5,485000,21
Máy Làm Sữa Chua Lock&Lock EJY211 - Hàng Chính Hãng,Đồ dùng nhà bếp,905000,501000,12,4.7,404000,45
Máy Xay Sinh Tố Xay Đá Panasonic MX-V310KRA - Hàng Chính Hãng,Đồ dùng nhà bếp,1620000,1318900,575,4.7,301100,19
Máy Vắt Cam Philips HR-2738 - Hàng Nhập Khẩu,Đồ dùng nhà bếp,619000,346000,177,4.8,273000,44
Lò Nướng Không Khí Lock&Lock EJF691 (10 Lít) - Hàng Chính Hãng,Đồ dùng nhà bếp,6045000,3450000,5,4,2595000,43
Bếp Nướng Điện Happy Time Sunhouse HTD4606 - Hàng chính hãng,Đồ dùng nhà bếp,669000,300400,534,4.5,368600,55
Vỉ Nướng Điện Lock&Lock EJG221 (1300W),Đồ dùng nhà bếp,1329000,899000,59,4.7,430000,32
Nồi Lẩu Điện MiNi Đa Năng,Đồ dùng nhà bếp,299000,107500,52,4.7,191500,64
Máy Vắt Cam Lock&Lock EJJ236 (700ml) - Hàng chính hãng,Đồ dùng nhà bếp,405000,240000,31,4.5,165000,41
Lò Nướng Điện Đa Năng Comet CM6510 (10L) - Đen - Hàng Chính Hãng,Đồ dùng nhà bếp,630000,366600,183,4.6,263400,42
Nồi Cơm Điện Lock&Lock EJR716IVY 0.8L - Hàng Chính Hãng,Đồ dùng nhà bếp,1592000,975000,0,0,617000,39
Nồi cơm cao tần Toshiba 1.8 lít RC-18IX1PV - Hàng Chính Hãng,Đồ dùng nhà bếp,4900000,2389900,145,4.7,2510100,51
Máy Ép Trái Cây Philips HR1811 (300W) - Trắng Xanh - Hàng chính hãng,Đồ dùng nhà bếp,1409000,967000,17,4.5,442000,31
Máy ép chậm cỡ lớn RH-312 ép rau củ hoa quả 95% lượng nước,Đồ dùng nhà bếp,3500000,1099000,7,3.1,2401000,69
Nồi Áp Suất Điện Philips HD2103 (5L) - Hàng Chính Hãng,Đồ dùng nhà bếp,2149000,1579000,18,4.8,570000,27
Lò Vi Sóng Điện Tử Có Nướng Sharp R-G272VN-S - Hàng chính hãng,Đồ dùng nhà bếp,2200000,1395300,422,4.6,804700,37
Bình Đun Siêu Tốc Electrolux EEK-1303K (1.5L) - Hàng chính hãng,Đồ dùng nhà bếp,850000,449900,152,4.6,400100,47
Bình Đun Nước Siêu Tốc Comet CM8217 - Hàng chính hãng,Đồ dùng nhà bếp,189000,138900,129,4.5,50100,27
"Nồi Chiên Không Dầu Điện Tử BlueStone AFB-5880 (5,5 Lít) - Hàng Chính Hãng",Đồ dùng nhà bếp,3999000,2308900,55,4.7,1690100,42
Máy Nướng Bánh Mì Lock& Lock EJB221BLU (730 - 870 W) - Hàng chính hãng,Đồ dùng nhà bếp,975000,529000,17,4.5,446000,46
Ca lẩu điện hấp mini cao cấp màu ngẫu nhiên,Đồ dùng nhà bếp,329000,99000,20,4.5,230000,70
Nồi Cơm Điện Midea CM06SA - Hàng Chính Hãng,Đồ dùng nhà bếp,570000,439900,360,4.6,130100,23
Máy Đánh Trứng Philips HR3705 (300W) - Hàng Chính Hãng,Đồ dùng nhà bếp,779000,602900,285,4.7,176100,23
Nồi chiên không dầu Ferroli FAF4.0M (4 lít) - Hàng chính hãng,Đồ dùng nhà bếp,1400000,769000,0,0,631000,45
Nồi cơm điện tử Toshiba 1.8 lít RC-18NTFVN(W) - HÀNG CHÍNH HÃNG,Đồ dùng nhà bếp,4990000,2189000,20,5,2801000,56
Nồi lẩu điện mini có tay cầm đa năng,Đồ dùng nhà bếp,299000,115000,58,4.3,184000,62
Máy Xay Sinh Tố Toshiba MX-60T(H) (600W - 1.5 Lít) - Hàng Chính Hãng,Đồ dùng nhà bếp,890000,535000,258,4.6,355000,40
Bếp Hồng Ngoại Sunhouse SHD6011 - Đen- hàng chính hãng,Đồ dùng nhà bếp,890000,473100,345,4.5,416900,47
Nồi Chiên Không Dầu Philips HD9200/90 - Hàng Chính Hãng,Đồ dùng nhà bếp,2690000,2329000,2,5,361000,13
Nồi Cơm Điện Mini đa năng 0.8 lít Lock&Lock EJR326 - Hàng chính hãng,Đồ dùng nhà bếp,1349000,799000,64,4.7,550000,41
Máy Xay Sinh Tố Philips HR2051 450W (1.25L) - Hàng chính hãng,Đồ dùng nhà bếp,689000,527040,3,4.3,161960,24
Máy xay sinh tố cầm tay xiaomi deerma juicer blender DEM-NU05 bản quốc tế 2020 - Hàng chính hãng,Đồ dùng nhà bếp,799000,499000,46,4.6,300000,38
Máy xay sinh tố cầm tay Meet Juice dung tích 500ml,Đồ dùng nhà bếp,350000,253000,1,5,97000,28
Máy vắt cam Bear CZJ-A04B1 - Hàng Chính Hãng,Đồ dùng nhà bếp,499000,268900,60,4.8,230100,46
"Máy xay thịt, cá, xay đa năng Bcook 2 lưỡi dao kép cối thủy tinh (350W) - Hàng chính hãng",Đồ dùng nhà bếp,590000,490000,150,4.5,100000,17
NỒI CHIÊN KHÔNG DẦU ĐIỆN TỬ COSORI (AIR FRYER) 5.8 Qt / 5.5 LÍT- HÀNG CHÍNH HÃNG,Đồ dùng nhà bếp,4290000,2150000,46,5,2140000,50
Vỉ Nướng Điện Lock&Lock EJG211BLK (1800W) - Hàng chính hãng,Đồ dùng nhà bếp,1429000,849000,35,4.6,580000,41
Máy Xay Sinh Tố Đa Năng Sunhouse SHD5340 - Đen - Hàng chính hãng,Đồ dùng nhà bếp,1290000,810000,266,4.5,480000,37
Nồi Cơm Điện Tử Philips HD3060 (0.7L) - Đen - Hàng chính hãng,Đồ dùng nhà bếp,1990000,1449000,5,4.2,541000,27
Nồi chiên không dầu LOTTE 5.5 lít model LTS - AF5SM  - hàng chính hãng nhập khẩu Hàn Quốc,Đồ dùng nhà bếp,3950000,2730000,2,4.5,1220000,31
Nồi Chiên Không Dầu Philips HD9745 (1500W) - Hàng Chính Hãng,Đồ dùng nhà bếp,6349000,4829000,8,5,1520000,24
Nồi Cơm Điện Tử Toshiba RC-18DH2PV(W) - Hàng chính hãng,Đồ dùng nhà bếp,1690000,1289900,107,4.6,400100,24
Lò Chiên Không Khí 12 Lít Lock&Lock EJF696BLK (Kèm Quà Tặng)  - Hàng Chính Hãng,Đồ dùng nhà bếp,5458000,2950000,364,4.6,2508000,46
Nồi Cơm Điện Tiểu Quỷ Joyoung F-15Z609 (0.8L) - Hàng chính hãng,Đồ dùng nhà bếp,699000,468000,318,4.6,231000,33
[CHÍNH HÃNG] Máy Làm Sữa Hạt OLIVO X20 - Chống Tràn - Xay Mịn Không Cần Lọc - Máy Xay Nấu Đa Năng - Thương Hiệu Mỹ,Đồ dùng nhà bếp,2990000,2490000,28,4.6,500000,17
Máy Đánh Trứng Cầm Tay 7 Tốc Độ Công Suất 180W,Đồ dùng nhà bếp,350000,105000,1,5,245000,70
Nồi Chiên Không Dầu Philips HD9220/20 - Hàng nhập khẩu,Đồ dùng nhà bếp,4999000,2099000,108,4.7,2900000,58
Ấm Đun Siêu Tốc 2 Lớp Nagakawa NAG0314 (1.8 Lít) - Hàng Chính Hãng,Đồ dùng nhà bếp,560000,299000,58,4.6,261000,47
Ấm Đun Nước Thủy Tinh Bluestone KTB-3426 (1.7 Lít),Đồ dùng nhà bếp,539000,418900,241,4.6,120100,22
Nồi điện đa năng phủ chống dính cao cấp  - Nồi lẩu điện gia đình Bcook 1.8L - Hàng nhập khẩu,Đồ dùng nhà bếp,690000,538000,158,4.6,152000,22
Máy Xay Thịt Cối Inox Lock&Lock EJM172 (2 lít) Hàng Chính Hãng,Đồ dùng nhà bếp,1277000,690000,186,4.6,587000,46
Máy Xay Sinh Tố Cầm Tay Bluestone BLB-5251 (600W) - Hàng chính hãng,Đồ dùng nhà bếp,1399000,898900,63,4.3,500100,36
Máy làm sữa hạt đa năng,Đồ dùng nhà bếp,2990000,1199000,34,4.7,1791000,60
Nồi chiên không dầu Tefal EY201D15 - Hàng chính hãng,Đồ dùng nhà bếp,4729000,2999000,14,4.5,1730000,37
Máy xay sinh tố cầm tay Philips HR2534 - Hàng chính hãng,Đồ dùng nhà bếp,1099000,765000,10,4.7,334000,30
Máy Xay Sinh Tố Toshiba BL-70PR1NV (700W - 1.5 Lít) - Hàng Chính Hãng,Đồ dùng nhà bếp,1290000,879900,48,4.7,410100,32
Ấm Đun Nước Mặt Kính Hafele T-602C (1.7 Lít) - Hàng Chính Hãng,Đồ dùng nhà bếp,990000,749900,109,4.7,240100,24
Máy Xay Sinh Tố Đa Năng Sunhouse HappyTime HTD5113G (Xanh) - Hàng chính hãng,Đồ dùng nhà bếp,700000,259000,263,3.9,441000,63
Máy Làm Bánh 3 Trong 1 Tiross TS513 - Hàng Chính Hãng,Đồ dùng nhà bếp,980000,637000,369,4.5,343000,35
Nồi chiên không dầu Tefal EY701D15 - Hàng chính hãng,Đồ dùng nhà bếp,6599000,4969000,19,5,1630000,25
Nồi Chiên Không Dầu Lock&Lock EJF351BLK (5.2L) (Đen) - Hàng chính hãng,Đồ dùng nhà bếp,4700000,2470000,400,4.6,2230000,47
Nồi Chiên Không Dầu Magic A-801 (6.0 Lít) - Hàng Chính Hãng,Đồ dùng nhà bếp,2590000,1448900,292,4.6,1141100,44
Nồi chiên không dầu 5L mẫu 2020,Đồ dùng nhà bếp,1450000,687500,91,4.5,762500,53
Máy Xay Sinh Tố Electrolux EMB3025 (600ml) - Hàng Chính Hãng,Đồ dùng nhà bếp,1190000,499000,105,4.7,691000,58
Nồi Chiên Không Dầu Perfect GLA 609 (4L) - Hàng chính hãng,Đồ dùng nhà bếp,2299000,899000,761,4.5,1400000,61
"Máy Xay Thịt, Giò Chả, Tỏi Ớt Công Suất Lớn Dành Cho Gia Đình, Cửa Hàng",Đồ dùng nhà bếp,1500000,280000,3,4.7,1220000,81
Nồi cơm điện cao tần Tefal RK808168 - Hàng chính hãng,Đồ dùng nhà bếp,2739000,2219000,12,4.8,520000,19
Máy xay sinh tố Philips HR2222/00 - Hàng Chính Hãng,Đồ dùng nhà bếp,1650000,1180000,12,4.7,470000,28
Nồi Cơm Điện Philips HD3115/66 (1.8L) - Hàng Chính Hãng,Đồ dùng nhà bếp,1029000,850000,57,4.6,179000,17
Nồi Cơm Điện Cao Tần (IH) Philips HD4528/66 - Hàng Chính Hãng,Đồ dùng nhà bếp,3329000,2138000,12,4.3,1191000,36
Máy Xay Thịt Đa Năng Thân Inox Chopper Midimori GC-24338 (500W) - Đen - Hàng chính hãng,Đồ dùng nhà bếp,1250000,549000,292,4.5,701000,56
Bếp Đôi Điện Từ Hồng Ngoại Sunhouse SHB8609 (4000W) - Hàng chính hãng,Đồ dùng nhà bếp,3990000,1990000,15,4.5,2000000,50
Máy Làm Sữa Đậu Nành Lock&Lock EJS226 (1.3 Lít) - Hàng Chính Hãng,Đồ dùng nhà bếp,3125000,1790000,2,5,1335000,43
Máy ép chậm Panasonic MJ L500 - Hàng nhập khẩu,Đồ dùng nhà bếp,5999000,4120000,4,4.8,1879000,31
Nồi Cơm Điện Nắp Gài Nagakawa NAG0131 (1.2 Lít) - Hàng Chính Hãng,Đồ dùng nhà bếp,1045000,699000,26,4.8,346000,33
Máy xay sinh tô cầm tay Philips HR2537 - Model 2020 - Hàng chính hãng,Đồ dùng nhà bếp,1990000,1425000,4,4.5,565000,28
Ấm Siêu Tốc Thủy Tinh Sunhouse SHD1217- Hàng chính hãng,Đồ dùng nhà bếp,620000,372000,0,0,248000,40
Máy xay sinh tố cầm tay tiện lợi 500ml MeetJuice - 2019,Đồ dùng nhà bếp,550000,349000,90,4.5,201000,37
Nồi Cơm Điện Lock&Lock EJR431 Dung Tích 1 lít (Hàng Chính Hãng),Đồ dùng nhà bếp,977000,619000,103,4.6,358000,37
Máy xay thịt osaka japan new 2019 - Hàng Chính Hãng,Đồ dùng nhà bếp,600000,220000,83,4,380000,63
Máy đánh trứng tạo bọt cafe mini,Đồ dùng nhà bếp,99000,19490,1,1,79510,80
Máy Đánh Trứng Lock&Lock Hand Mixer EJM501BLK (300W) - Hàng chính hãng,Đồ dùng nhà bếp,909000,469000,15,4.6,440000,48
Bếp Ga Chống Nổ Mini Namilux Van An Toàn 2 Cấp Công Nghệ Nhật Bản-Hàng Chính Hãng (Giao Màu Ngẫu Nhiên),Đồ dùng nhà bếp,990000,218000,65,4.7,772000,78
Máy Xay Sinh Tố Lock&Lock EJM436 (250W - 600ml) - Hàng Chính Hãng,Đồ dùng nhà bếp,860000,550000,0,0,310000,36
Máy Xay Thịt Đa Năng Bear QSJ-B02Q1 - Chính Hãng,Đồ dùng nhà bếp,1250000,422000,13,4.5,828000,66
Máy Xay Sinh Tố Cầm Tay Mini Đa Năng,Đồ dùng nhà bếp,599000,295000,0,0,304000,51
Nồi Áp Suất Điện Comet CM6151 (6.0 Lít) - Hàng Chính Hãng,Đồ dùng nhà bếp,1490000,707900,235,4.6,782100,52
MÁY ÉP TRÁI CÂY TỐC ĐỘ CHẬM,Đồ dùng nhà bếp,750000,699000,58,4,51000,7
Bếp Hồng Ngoại Lock&Lock EJI421 (2000W) - Hàng Chính Hãng,Đồ dùng nhà bếp,2155000,1230000,0,0,925000,43
"Máy xay thịt đa năng cối inox 304 4 Lưỡi Đa Năng, Công suất 250W- Xay thịt, xay tỏi ới, xay rau củ quả",Đồ dùng nhà bếp,550000,245000,0,0,305000,55
Bình Đun Siêu Tốc 2 Lớp Nagakawa NAG0315 (1.8 Lít) - Hàng Chính Hãng,Đồ dùng nhà bếp,625000,415000,102,4.6,210000,34
Máy Ép Trái Cây Bluestone JEB-6545 (850W) - Hàng chính hãng,Đồ dùng nhà bếp,1599000,1273200,93,4.5,325800,20
"Nồi Nấu Cháo Cách Thủy 2 Tầng 2GOOD A300 (3,1 Lít) - Hàng Chính Hãng",Đồ dùng nhà bếp,650000,499000,124,4.6,151000,23
Máy Ép Trái Cây Philips HR1836 (500W) - Hàng chính hãng,Đồ dùng nhà bếp,2449000,2049000,0,0,400000,16
"Ca nấu đa năng Mishio MK214 600W 1,5L inox 304, nấu nước, nấu mì, lẩu - Màu trắng xám - Hàng chính hãng",Đồ dùng nhà bếp,599000,399000,40,4.7,200000,33
Nồi chiên không dầu Tefal - EY201866 - Hàng chính hãng,Đồ dùng nhà bếp,4399000,2759000,18,4.7,1640000,37
Bếp gas mini 100% Inox chống cháy nổ tiết kiệm gas cao cấp,Đồ dùng nhà bếp,268499,129000,25,4.6,139499,52
"Ca nấu mì, ăn lẩu, đun nước siêu tốc đa năng mini 2 tầng tặng kèm xửng hấp",Đồ dùng nhà bếp,130000,88338,2,3,41662,32
Nồi Điện Đa Năng Lock&Lock EJC141 (1.5 Lít) - Hàng Chính Hãng,Đồ dùng nhà bếp,1937000,998000,17,4.8,939000,48
Máy Làm Tỏi Đen Lock&Lock EJR136PUP (3 Lít) - Hàng Chính Hãng,Đồ dùng nhà bếp,1775000,939000,10,4.3,836000,47
Máy Làm Sữa Đậu Nành Joyoung DJ12C-A903SG (1.2L) - Hàng chính hãng,Đồ dùng nhà bếp,1990000,859000,240,4.6,1131000,57
Máy Xay Sinh Tố Philips HR2056 (450W) - Hàng chính hãng,Đồ dùng nhà bếp,829000,699000,11,4.8,130000,16
Máy xay thịt dành cho nhà bếp,Đồ dùng nhà bếp,619900,151500,4,5,468400,76
Nồi Áp Suất Comet CM6150 - Hàng Chính Hãng,Đồ dùng nhà bếp,809000,677100,165,4.7,131900,16
Máy tạo bọt sữa sạc USB 2 loại đầu khuấy cafe và đánh trứng,Đồ dùng nhà bếp,215000,164999,1,5,50001,23
Máy Đánh Trứng Cầm Tay Bear DDQ-B01K1 - Phiên Bản Quốc Tế - Hàng Chính Hãng,Đồ dùng nhà bếp,499000,298900,17,4.8,200100,40
Máy Xay Sinh Tố Đa Năng Cao Cấp 2 Tầng Lưỡi Nắp Bẹt Màu Nâu,Đồ dùng nhà bếp,358970,144800,9,5,214170,60
Nồi chiên không dầu Kalite Q10 - Hàng chính hãng,Đồ dùng nhà bếp,4560000,2990000,89,4.5,1570000,34
Bếp Nướng Điện Sunhouse SHD4607 (1500W) - Hàng chính hãng,Đồ dùng nhà bếp,590000,311900,6,4.5,278100,47
"Máy Xay Thịt Cối Thủy Tinh Lock&Lock Meat Chopper EJM156BLK 1 Lít - Hàng Chính Hãng, 4 Lưỡi Dao Cho Lực Nghiền Mạnh, Công Suất 400W",Đồ dùng nhà bếp,880000,529000,11,4.3,351000,40
NỒI LẨU NƯỚNG ĐA NĂNG 2 TRONG 1,Đồ dùng nhà bếp,1590000,274000,6,5,1316000,83
Nồi cơm điện Comet CM8028 1.2L - Hàng chính hãng - Giao Hoa Văn Ngẫu Nhiên,Đồ dùng nhà bếp,462000,310000,155,4.5,152000,33
Nồi Chiên Không Dầu Điện Tử Lock&Lock EJF286BLK 6.5L - Hàng chính hãng,Đồ dùng nhà bếp,4850000,2690000,56,4.8,2160000,45
Nồi cơm điện tách đường Mishio MK188 - Hàng chính hãng,Đồ dùng nhà bếp,2990000,549000,9,4.7,2441000,82
Máy Vắt Cam Lock&Lock EJJ241 (1.2L) - Hàng chính hãng,Đồ dùng nhà bếp,530000,530000,277,4,0,0
"Nồi Cơm Điện 1L Fujika FJ-NC1005 Công Suất 400W Lồng Men Chống Dính Cho 2,3 Người Ăn (Mẫu Ngẫu Nhiên)-Hàng Chính Hãng",Đồ dùng nhà bếp,499000,258000,34,4.5,241000,48
"Máy Xay, Ép Sinh Tố Hoa Quả Cầm Tay Pin Sạc Tiện Lợi",Đồ dùng nhà bếp,600000,103500,16,4.1,496500,83
Nồi cơm tách đường điện tử Mishio MK194 5L – Màu đen - Hàng chính hãng,Đồ dùng nhà bếp,2990000,599000,17,4.2,2391000,80
Bình đun siêu tốc Toshiba 1.7 lít KT-17SH2NV - HÀNG CHÍNH HÃNG,Đồ dùng nhà bếp,790000,479900,60,4.6,310100,39
Máy Đánh Trứng Philips HR3705 (300W) - Hàng nhập khẩu,Đồ dùng nhà bếp,790000,590000,13,5,200000,25
Lò Nướng Kangaroo KG295 (48L) - Hàng chính hãng,Đồ dùng nhà bếp,2810000,1129000,140,4.3,1681000,60
Nồi lẩu đa năng mini 2 tầng kèm khay hấp inox -NLHI,Đồ dùng nhà bếp,355000,96500,9,4.2,258500,73
Nồi Nấu Chậm Panasonic 3 Lít  NF-N30ASRA - Hàng Chính Hãng,Đồ dùng nhà bếp,1500000,1301900,104,4.7,198100,13
Máy Hút Mùi Tích Hợp Than Hoạt Tính Nagakawa NAG1803-70T (70cm) - Hàng Chính Hãng,Đồ dùng nhà bếp,2600000,1499000,27,4.6,1101000,42
Nồi Cơm Điện Tử Cuckoo CR-1010F (1.8L)  - Hàng Chính Hãng,Đồ dùng nhà bếp,2064000,1580000,110,4.6,484000,23
Nồi Cơm Điện Nắp Gài Sharp KS-181TJV - 1.8 L - Hàng chính hãng,Đồ dùng nhà bếp,899000,499000,7,4.6,400000,44
Bếp Nướng Điện Không Khói Comet CM5665 (1400W) - Hàng Chính Hãng,Đồ dùng nhà bếp,620000,337000,54,4,283000,46
Nồi Áp Suất Điện Tử Philips HD2136 (5L) - Hàng Chính Hãng,Đồ dùng nhà bếp,2690000,2429000,0,0,261000,10
Máy Đánh Trứng N38D 300W Gọn Nhẹ,Đồ dùng nhà bếp,540000,355136,57,4.5,184864,34
Nồi Cơm Điện Sharp KS-A08V-R (0.72 lít) - Đỏ - Hàng chính hãng,Đồ dùng nhà bếp,850000,769000,1,5,81000,10
"Máy tạo bọt cafe, sữa, đánh trứng mini cầm tay MFB1501D kích thước nhỏ gọn, tiện dụng ",Đồ dùng nhà bếp,390000,259999,0,0,130001,33
Máy Pha Cà Phê Electrolux ECM3505 - Đen - Hàng chính hãng,Đồ dùng nhà bếp,890000,665800,91,4.5,224200,25
Máy ép Mishio Slowjuicer MK61 - Hàng chính hãng,Đồ dùng nhà bếp,1490000,699000,10,3.7,791000,53
"Ấm Siêu Tốc Inox 5L Fujika FJ-SD50 Công Suất 1500W Tiết Kiệm Điện Cho Quán,Nhà Hàng,Nhà Đông Người-Hàng Chính Hãng",Đồ dùng nhà bếp,599000,219000,16,4.2,380000,63
Nồi Chiên Không Dầu Philips HD9218 (1425W) - Hàng Chính Hãng,Đồ dùng nhà bếp,4200000,2869600,34,4.7,1330400,32
Nồi Lẩu Điện Sunhouse SHD4521 (3L) - Hàng chính hãng,Đồ dùng nhà bếp,550000,363000,256,4.6,187000,34
Bếp Từ Đơn Lock&Lock EJI411 (2000W) - Hàng Chính Hãng,Đồ dùng nhà bếp,2045000,1170000,0,0,875000,43
Nồi cơm cao tần Toshiba 1 lít RC-10IX1PV - Hàng Chính Hãng,Đồ dùng nhà bếp,3900000,2299900,144,4.6,1600100,41
Máy Cầm Tay Mini Đánh Trứng Tạo Bọt Cà Phê Khuấy Cực Mạnh - Pin - 1 Cái - Màu Ngẫu Nhiên ,Đồ dùng nhà bếp,50000,20000,2,5,30000,60
Kem Dưỡng Cấp Nước Cho Da Hỗn Hợp Neutrogena Hydro Boost Water Gel 50ml,Làm Đẹp - Sức Khỏe,385000,278000,90,5,107000,28
Dầu Gội Rejoice Siêu Mượt - 900ML,Làm Đẹp - Sức Khỏe,177000,135000,10,5,42000,24
"Khẩu trang SMS đi mưa HAMITA Hộp 50 cái - 1 lớp vải tích hợp - ĐI MƯA, NGĂN GIỌT BẮN, hạn chế lem son môi, rộng hơn/phủ kín hơn, quai đeo thoải mái",Làm Đẹp - Sức Khỏe,75000,49000,94,4.2,26000,35
Dầu Gội Head & Shoulders Bạc Hà Mát Lạnh (1200ml),Làm Đẹp - Sức Khỏe,279000,195000,9,5,84000,30
Combo 2 Dầu gội Romano hương nước hoa 650g/chai,Làm Đẹp - Sức Khỏe,346000,276000,384,4.6,70000,20
"Lactomin (viên nang) bổ sung 3 loại men vi sinh có ích được bao vi nang, dùng cho người bị tiêu chảy, táo bón, dùng kháng sinh dài ngày",Làm Đẹp - Sức Khỏe,185000,185000,1,3,0,0
Nước tẩy trang Loreal Micellar Water 3-in-1 Refreshing Even For Sensitive Skin,Làm Đẹp - Sức Khỏe,189000,137000,315,4.8,52000,28
Combo 2 Tắm gội 2 trong 1 Romano hương nước hoa 650g/chai,Làm Đẹp - Sức Khỏe,324000,259000,447,4.7,65000,20
"Sữa Rửa Mặt Cetaphil Gentle Skin Cleaner (500ml) - 8394107341305,9318637069637",Làm Đẹp - Sức Khỏe,290000,284000,1676,4.7,6000,2
Kem dưỡng thể tế bào gốc hoa Asa Zakura,Làm Đẹp - Sức Khỏe,500000,185000,5,5,315000,63
Bộ Đôi Kem chống nắng dưỡng da dạng sữa kiềm dầu khô thoáng hoàn hảo siêu tiết kiệm Anessa Gold Milk 60ml + Gold Milk 20ml,Làm Đẹp - Sức Khỏe,960000,589000,135,4.8,371000,39
Combo 2 Lăn khử mùi Romano Classic kháng khuẩn & khô thoáng cả ngày 50ml*2,Làm Đẹp - Sức Khỏe,124000,99000,181,4.7,25000,20
Nước tẩy trang L'Oreal Paris 3-in-1 Micellar Water 400ml,Làm Đẹp - Sức Khỏe,189000,135000,125,4.7,54000,29
"Thực Phẩm Chức Năng Viên Uống Hỗ Trợ Giảm Cân Thiên Nhiên Lily Slim , giảm cân mạnh từ 5-7kg sau 1 liệu trình, không tác dụng phụ, giúp cơ thể săn gọn tự nhiên an toàn, sản phẩm đạt chuẩn GMP",Làm Đẹp - Sức Khỏe,500000,450000,18,5,50000,10
Combo 2 Xịt toàn thân Romano Attitude nồng ấm cá tính 150ml,Làm Đẹp - Sức Khỏe,190000,152000,146,4.7,38000,20
Bao cao su Durex Invisible Extra Thin Extra Sensitive 1 Hộp 10 Bao,Làm Đẹp - Sức Khỏe,247000,189000,13,4.8,58000,23
Cốc Hỗ Trợ Nam Giới,Làm Đẹp - Sức Khỏe,250000,65000,1941,4.5,185000,74
Ghế massage mini SYNCA CirC - MR320,Làm Đẹp - Sức Khỏe,30000000,30000000,0,0,0,0
Combo Dầu Gội (640g) Và Dầu Xả (620g) Tresemmé Keratin Smooth Tinh Dầu Argan Và Keratin Vào Nếp Suôn Mượt,Làm Đẹp - Sức Khỏe,370000,314000,703,4.7,56000,15
Nước Tẩy Trang L'Oreal 3 In 1 Micellar Làm Sạch Sâu (400ml),Làm Đẹp - Sức Khỏe,199000,146000,21,4.8,53000,27
"Kem Chống Nắng Dành Cho Da Bóng Dầu, Dễ Nổi Mụn La Roche-Posay Anthelios Anti-Imperfection 50ml",Làm Đẹp - Sức Khỏe,495000,448000,23,4.6,47000,9
Kem Dưỡng Neutrogena HB Water Gel 15g,Làm Đẹp - Sức Khỏe,195000,85000,71,4.7,110000,56
Mặt Nạ Kiểm Soát Dầu Và Mụn Naruko Tràm Trà Bản Đài - Tea Tree Shine Control And Blemish Clear Mask (8 Miếng / Hộp),Làm Đẹp - Sức Khỏe,299000,196000,1553,4.8,103000,34
Combo 2 Xịt toàn thân Romano Classic cổ điển lịch lãm 150ml,Làm Đẹp - Sức Khỏe,195000,152000,126,4.7,43000,22
Kem Dưỡng Làm Dịu Kích Ứng Và Phục Hồi Da La Roche-Posay Cicaplast Baume B5 (40ml),Làm Đẹp - Sức Khỏe,350000,228000,323,4.7,122000,35
Combo Sữa Tắm + Sữa Dưỡng Thể Love Beauty And Planet Làm Sáng Da (400ml/Chai),Làm Đẹp - Sức Khỏe,325000,249000,128,4.8,76000,23
Dung Dịch Tẩy Tế Bào Chết Paula's Choice Skin Perfecting 2% BHA Liquid (30ml),Làm Đẹp - Sức Khỏe,339000,250000,362,4.8,89000,26
Combo Sữa Tắm L'amont En Provence Cherry Blossom Shower Gel Hương Hoa Anh Đào + Hoa Hồng (500ml / Chai),Làm Đẹp - Sức Khỏe,298000,119000,2662,4.6,179000,60
Son Kem Lì Black Rouge Air Fit Velvet Tint – Hàn Quốc,Làm Đẹp - Sức Khỏe,250000,139000,1258,4.7,111000,44
ISHOW Combo Phấn Nước Cushion Kiềm Dầu Chống Nắng Cao Cấp SPF 50+/PA +++ ( Kèm 2 son môi Lipstick ) Lớp nền tự nhiên căng bóng che phủ hoàn hảo,Làm Đẹp - Sức Khỏe,1980000,880000,0,0,1100000,56
Bộ Đôi Nước Súc Miệng Hương Bạc Hà Listerine Cool Mint (750ml/ Chai) - 8850007800071,Làm Đẹp - Sức Khỏe,252500,147000,1122,4.8,105500,42
Vaseline 50x Serum Chống Nắng Cơ Thể SPF50 + Dưỡng Da Sáng Khoẻ 200ml,Làm Đẹp - Sức Khỏe,130000,107000,302,4.7,23000,18
Bao cao su Durex Performa 12 bao,Làm Đẹp - Sức Khỏe,255000,197000,191,4.8,58000,23
Scurma Fizzy - Khỏe Nhanh Dạ Dày,Làm Đẹp - Sức Khỏe,295000,295000,0,0,0,0
Gel Mụn Liền Sẹo Gamma Chemecals Derma Forte 15g,Làm Đẹp - Sức Khỏe,157000,102000,1089,4.7,55000,35
"Combo Kem Dưỡng Giảm Mụn, Ngừa Vết Thâm, Se Nhỏ Lỗ Chân Lông La Roche-Posay Effaclar Duo+ M694050 (40ml) + Gel Rửa Mặt Dành Cho Da Dầu Nhạy Cảm La Roche-Posay Effaclar Purifying Foaming Gel 100771312 (50ml)",Làm Đẹp - Sức Khỏe,455000,359000,2132,4.7,96000,21
Kem chống nắng dưỡng da dạng sữa bảo vệ hoàn hảo Anessa Perfect UV Sunscreen Skincare Milk SPF 50+ PA++++ 60ml,Làm Đẹp - Sức Khỏe,685000,484000,574,4.7,201000,29
Dầu gan cá ( sụn vi cá mập),Làm Đẹp - Sức Khỏe,699000,699000,1,4,0,0
"Sữa Chống Nắng Dưỡng Da Trắng Mịn Tối Ưu Sunplay Skin Aqua Clear White SPF50+, PA++++ (55g)",Làm Đẹp - Sức Khỏe,192000,155000,142,4.8,37000,19
Sữa chống nắng dịu nhẹ cho da nhạy cảm và trẻ em Anessa SPF 50+ PA++++ 60ml,Làm Đẹp - Sức Khỏe,685000,494000,184,5,191000,28
Xà Phòng Cải Thiện Thâm Mông Pelican Hip Care Soap nội địa Nhật,Làm Đẹp - Sức Khỏe,250000,118000,246,4.7,132000,53
"Bộ dầu gội thảo dược gừng dừa Cocayhoala hỗ trợ trị gàu, giảm nấm ngứa, dung tích 440g/chai- 95% thành phần từ gừng tươi hữu cơ còn nguyên xơ gừng, hỗ trợ trị rụng tóc, kích thích mọc tóc vượt trội",Làm Đẹp - Sức Khỏe,600000,441000,82,4.8,159000,27
Nước hoa hồng chống viêm không mùi Klairs Supple Preparation Unscented Toner,Làm Đẹp - Sức Khỏe,385000,220000,165,5,165000,43
Nước Tẩy Trang Làm Sạch Sâu Cho Da Nhạy Cảm La Roche-Posay Micellar Water Ultra Sensitive Skin 400ml,Làm Đẹp - Sức Khỏe,445000,359000,599,4.7,86000,19
Combo 2 Xịt khử mùi Enchanteur Charming/ Sensation/ Delightful/Romantic/Magic 150ml/Chai,Làm Đẹp - Sức Khỏe,194000,142000,101,4.7,52000,27
Nước Rửa Tay Diệt Khuẩn Lifebuoy Bảo Vệ Vượt Trội Túi 21126130 (450g),Làm Đẹp - Sức Khỏe,53000,47000,766,4.8,6000,11
Combo 2 Lăn khử mùi nước hoa Enchanteur Charming 50ml/ Chai,Làm Đẹp - Sức Khỏe,156000,113000,175,4.7,43000,28
Combo 2 Dầu gội nước hoa Enchanteur Sensation/Charming dưỡng tóc siêu mượt 650gr/Chai,Làm Đẹp - Sức Khỏe,334000,219000,90,4.8,115000,34
Sữa rửa mặt làm sạch từ trà xanh đảo Jeju Innisfree Green Tea Foam Cleanser 150ml - NEW,Làm Đẹp - Sức Khỏe,220000,220000,70,4.8,0,0
Vớ y khoa đùi Hỗ Trợ Điều Trị suy giãn tĩnh mạch chân JOBST Relief chuẩn áp lực 20-30mmHg - Da (tất y khoa),Làm Đẹp - Sức Khỏe,1200000,1030000,30,4.8,170000,14
"Kem Chống Nắng Dạng Sữa Senka Perfect UV Milk SPF 50+, PA++++ 41095 (40ml)",Làm Đẹp - Sức Khỏe,160000,119000,357,4.6,41000,26
Mặt Nạ Ngủ Cho Môi Phiên Bản Miniature Laneige Lip Sleeping Mask Berry (8g) – 270281585,Làm Đẹp - Sức Khỏe,210000,210000,1510,4.7,0,0
Bộ sản phẩm Senka làm sạch và chống nắng dành cho da mụn (Senka A.L.L.Clear Water Fresh 230ml + SRM Acne Care 100g + Senka Perfect UV Essence 50g),Làm Đẹp - Sức Khỏe,374000,209000,466,4.8,165000,44
"Dầu Gội Sạch Gàu Antisol pH6.5 Chiết Xuất Dược Liệu Ngăn Ngừa Gàu, Rụng Tóc, Ngứa Da Đầu Tái Phát - Chai 240ml - Thương Hiệu iCare Pharma",Làm Đẹp - Sức Khỏe,320000,283000,17,4.6,37000,12
Trứng Rung Tình Yêu 2 Đầu,Làm Đẹp - Sức Khỏe,71000,35000,207,4.6,36000,51
Combo 2 Lăn khử mùi Romano kháng khuẩn & khô thoáng cả ngày 50mlx2 Attitude,Làm Đẹp - Sức Khỏe,125000,99000,74,4.8,26000,21
Kem chống nắng dạng tinh chất Senka Perfect UV Essence 50g,Làm Đẹp - Sức Khỏe,160000,119000,451,4.6,41000,26
Máy tăm nước cầm tay Panasonic công nghệ siêu âm EW1611 - Hàng Chính Hãng,Làm Đẹp - Sức Khỏe,4200000,3200000,17,4.6,1000000,24
Sữa rửa mặt hỗ trợ trị mụn Senka Perfect Whip Acne Care 100g,Làm Đẹp - Sức Khỏe,105000,75000,1153,4.7,30000,29
Nước Tẩy Trang Làm Sạch Sâu & Kiểm Soát Bã Nhờn Cho Da Dầu Nhạy Cảm La Roche-Posay Micellar Water Ultra Oily Skin 400ml,Làm Đẹp - Sức Khỏe,445000,359000,239,4.7,86000,19
Set 3 Cây Son Kem Lì Herorange Fluffy Lip Glaze,Làm Đẹp - Sức Khỏe,245000,69000,334,4.6,176000,72
Gel vệ sinh phụ nữ X2 Nano Nghệ Cocayhoala Giảm Mùi Hôi - Giảm Ngứa - Giảm Khí Hư 150ml,Làm Đẹp - Sức Khỏe,300000,198000,123,4.7,102000,34
Combo 2 Lăn khử mùi trắng da Enchanteur Charming 50ml/ Chai,Làm Đẹp - Sức Khỏe,166000,119000,130,4.8,47000,28
Sữa Rửa Mặt Cetaphil Gentle Skin Cleanser (125ml),Làm Đẹp - Sức Khỏe,185000,118900,870,4.6,66100,36
"Kem chống nắng Hàn Quốc Lagivado dành cho cả da dầu mụn, nhạy cảm Multi-Protection Sun Screen SPF50+ PA++++ - 30g",Làm Đẹp - Sức Khỏe,250000,250000,37,4.6,0,0
Sữa Tắm Lifebuoy Bảo Vệ Vượt Trội 10 (1.1Kg),Làm Đẹp - Sức Khỏe,166500,141000,276,4.5,25500,15
Bao cao su Durex Kingtex 12 bao,Làm Đẹp - Sức Khỏe,129000,102000,11,4.8,27000,21
Bông Tẩy Trang Ipek 130 Miếng (Thổ Nhĩ Kì),Làm Đẹp - Sức Khỏe,40000,30900,578,4.7,9100,23
Dầu xả OGX Renewing Argan oil of Morocco 385ml -101063812,Làm Đẹp - Sức Khỏe,295000,231000,11,4.7,64000,22
Tinh chất ngừa mụn thâm The Ordinary Niacinamide 10% + Zinc 1%,Làm Đẹp - Sức Khỏe,279000,279000,77,4.8,0,0
Kem Dưỡng Cấp Nước Cho Da Hỗn Hợp Neutrogena Hydro Boost Water Gel 50ml,Làm Đẹp - Sức Khỏe,385000,278000,90,5,107000,28
Máy Sấy Tóc Philips HP8108,Làm Đẹp - Sức Khỏe,250000,175500,282,4.7,74500,30
Gel Rửa Tay Khô Sạch Siêu Nhanh Lifebuoy Bảo Vệ Vượt Trội 10 (Chai Nắp 235ml),Làm Đẹp - Sức Khỏe,73000,67000,224,4.7,6000,8
Nước tẩy trang SENKA A.L.L. CLEAR WATER Micellar Formula White 230ml,Làm Đẹp - Sức Khỏe,99000,72000,687,4.7,27000,27
Combo Dầu gội và Sữa tắm Romano Classic cổ điển lịch lãm 650gr/chai,Làm Đẹp - Sức Khỏe,335000,268000,154,4.7,67000,20
Khẩu Trang Y Tế TDCare 4 Lớp-Màu Trắng-Hộp 50 Cái,Làm Đẹp - Sức Khỏe,160000,36000,848,4.7,124000,78
Tinh chất truyền năng lượng Shiseido Ultimune Power Infusing Concentrate N 50ml,Làm Đẹp - Sức Khỏe,2750000,2750000,0,0,0,0
Tinh chất chống nắng nâng tông dành cho da khô/thường Sunplay Skin Aqua Tone Up UV Essence Lavender SPF50+ PA++++ (50g),Làm Đẹp - Sức Khỏe,175000,149000,485,4.7,26000,15
Gel bôi trơn Durex Play Classic 50ml,Làm Đẹp - Sức Khỏe,92000,75000,19,4.8,17000,18
Bộ Đôi Dầu Gội Và Dầu Xả (385ml) Biotin & Collagen OGX Shampoo và Conditioner,Làm Đẹp - Sức Khỏe,600000,439000,139,4.3,161000,27
"Đai lưng bụng ngải cứu - Đai chườm nóng bằng điện, ruột bằng ngải cứu khô và 12 loại thảo dược khác. Đai ngải cứu dùng được cho toàn bộ cơ thể, hỗ trợ giảm đau do thoát vị đĩa đệm, do làm việc quá sức",Làm Đẹp - Sức Khỏe,650000,600000,1,5,50000,8
"Máy sấy tóc, máy sấy tóc công suất 2000W, máy sấy tóc 2 chiều, tặng kèm 5 phụ kiện sấy tóc tạo kiểu chuyên dụng",Làm Đẹp - Sức Khỏe,550000,105000,88,4.5,445000,81
Nước Rửa Tay Diệt Khuẩn Lifebuoy Bảo Vệ Vượt Trội Túi 21126130 (450g),Làm Đẹp - Sức Khỏe,53000,45000,62,5,8000,15
Kem dưỡng ẩm dành cho da dầu và da hỗn hợp Laneige Water Bank Hydro Cream Ex 50ml,Làm Đẹp - Sức Khỏe,850000,726000,225,4.8,124000,15
Kem Dưỡng Neutrogena HB Water Gel 15g,Làm Đẹp - Sức Khỏe,195000,85000,71,4.7,110000,56
Lưỡi Lược Thép Lược Bướm Tập Quay,Làm Đẹp - Sức Khỏe,96000,55500,99,4.6,40500,42
Cân Sức Khỏe Xiaomi Thông Minh Mi Smart Scale 2,Làm Đẹp - Sức Khỏe,399000,299000,353,4.7,100000,25
Hộp 60 Miếng Mặt Nạ giảm Quầng Thâm Và Bọng Mắt BIOAQUA,Làm Đẹp - Sức Khỏe,115000,59000,214,4.6,56000,49
Vớ y khoa đùi Hỗ Trợ Điều Trị suy giãn tĩnh mạch chân JOBST Relief chuẩn áp lực 20-30mmHg - Da (tất y khoa),Làm Đẹp - Sức Khỏe,1200000,1030000,30,4.8,170000,14
"Dung dịch vệ sinh nam Tê Tê Men 120ml hiện đại, thư giãn và tăng hưng phấn",Làm Đẹp - Sức Khỏe,135000,69000,123,4.7,66000,49
Lăn Khử Mùi Perspirex Antiperspirant Roll-On (20ml),Làm Đẹp - Sức Khỏe,300000,179000,189,4.7,121000,40
[MẪU 2020] Lăn khử mùi hỗ trợ đặc trị Etiaxil Detranspirant Traitement Aisselles 15ml,Làm Đẹp - Sức Khỏe,260000,197000,197,4.8,63000,24
Ghế massage mini SYNCA CirC - MR320,Làm Đẹp - Sức Khỏe,30000000,30000000,0,0,0,0
Dầu Gội Ogx Biotin & Collagen Shampoo 385ml,Làm Đẹp - Sức Khỏe,300000,231000,82,4.7,69000,23
Gel bôi trơn Durex K-Y Jelly 50g - KY Jelly,Làm Đẹp - Sức Khỏe,89000,71000,7,5,18000,20
Combo 6 hộp bông tẩy trang Silcot (82 miếng/hộp),Làm Đẹp - Sức Khỏe,222000,184000,183,4.5,38000,17
Máy đo đường huyết Contour TS - mg/dL (Gồm 1 máy đo+ 05 kim lấy máu+ 01 Bút lấy máu),Làm Đẹp - Sức Khỏe,1890000,900000,2,4.5,990000,52
Kem Dưỡng Trắng Da Tối Ưu Hada Labo Perfect White Cream 50g,Làm Đẹp - Sức Khỏe,220000,173000,169,4.5,47000,21
"Sữa chống nắng nâng tông dành cho da dầu/hỗn hợp Sunplay Skin Aqua Tone Up UV Milk (Mint Green) (dành cho da sáng, có khuyết điểm đỏ) (50g)",Làm Đẹp - Sức Khỏe,175000,147000,193,4.7,28000,16
Tinh Chất Làm Sáng Da Balance Vitamin C Brightening Serum Glow & Radiance (30ml),Làm Đẹp - Sức Khỏe,250000,139000,43,4.5,111000,44
Kem nền dưỡng da đa năng mini - naturaglacé makeup cream mini,Làm Đẹp - Sức Khỏe,528000,448800,4,3.8,79200,15
Kem Chống Nắng Sáng Hồng Da Bảo Vệ 12h L'oreal SPF50/PA+++ UVP  (30ml),Làm Đẹp - Sức Khỏe,148000,107000,121,4.7,41000,28
COMBO 3 GÓI  BÔNG TẨY TRANG BỀ MẶT MỊN BẠCH TUYẾT (GÓI 180 MIẾNG),Làm Đẹp - Sức Khỏe,180000,76600,506,4.8,103400,57
Nhiệt Kế Điện Tử Hồng Ngoại Đo Trán Microlife FR1MF1,Làm Đẹp - Sức Khỏe,1150000,705000,263,4.6,445000,39
Máy tăm nước cầm tay Panasonic công nghệ siêu âm EW1611 - Hàng Chính Hãng,Làm Đẹp - Sức Khỏe,4200000,3200000,17,4.6,1000000,24
Cây Massage Đầu Thư  Giản Xả Stress - Màu Ngẫu Nhiên,Làm Đẹp - Sức Khỏe,60000,19900,17,4.8,40100,67
"Kem Dưỡng Giảm Mụn, Ngừa Thâm, Thông Thoáng Lỗ Chân Lông La Roche-Posay Effaclar Duo+ 40ml",Làm Đẹp - Sức Khỏe,455000,279000,43,4.6,176000,39
Máy Sấy Tóc Hairdryver An Toàn Và Chuyên Nghiệp - Tích Hợp Chế Độ Nóng Phù Hợp Với Người Tiêu Dùng - Thiết Kế Hiện Đại - Tạo Kiểu Tóc Salon Dễ Dàng - Hàng Chính Hãng,Làm Đẹp - Sức Khỏe,299000,125000,116,4.7,174000,58
Bộ 2 Dầu gội và dầu xả OGX Ever straightening + brazilian keratin therapy 385ml,Làm Đẹp - Sức Khỏe,590000,419000,17,4.3,171000,29
"Sữa Chống Nắng Hằng Ngày Dưỡng Trắng Sunplay Skin Aqua Clear White SPF 50+, PA++++ (25g)",Làm Đẹp - Sức Khỏe,109000,95000,86,4.7,14000,13
Cân điện tử thông minh Xiaomi Body Composition Scale 2 - Chính hãng,Làm Đẹp - Sức Khỏe,990000,449000,81,4.7,541000,55
"Sữa Chống Nắng Nâng Tông Dành Cho Da Dầu/Hỗn Hợp Sunplay Skin Aqua Tone Up UV Milk Happiness Aura (Rose) (Cho Da Sáng Hồng, Khuyết Điểm Xanh) (50g)",Làm Đẹp - Sức Khỏe,175000,144000,6,4.7,31000,18
Kem dưỡng da nhạy cảm EUBOS Senstive Moisturizing Cream (50ml),Làm Đẹp - Sức Khỏe,870000,740000,3,4.7,130000,15
Sáp Dưỡng Môi Hồng Xinh Vaseline Lip Therapy Rosy Lip (7g) - 305210231597,Làm Đẹp - Sức Khỏe,87500,61500,445,4.7,26000,30
Nước Hoa Hồng Simple Kind To Skin Soothing Facial Toner 200ml - Mẫu Mới,Làm Đẹp - Sức Khỏe,250000,95000,16,4.8,155000,62
Cốc Hỗ Trợ Nam Giới tập luyện,Làm Đẹp - Sức Khỏe,300000,57000,110,4.5,243000,81
Nước hoa hồng Some By Mi AHA- BHA- PHA 30 Days Miracle Toner,Làm Đẹp - Sức Khỏe,405000,211000,174,4.7,194000,48
Combo 2 Xịt toàn thân Romano Force tươi mát năng động 150ml,Làm Đẹp - Sức Khỏe,195000,152000,123,4.7,43000,22
Sữa Rửa Mặt Tạo Bọt Chiết Xuất Tơ Tằm Trắng Senka Perfect Whip 120g - 14839,Làm Đẹp - Sức Khỏe,99000,69000,755,4.6,30000,30
Dầu Gội Head Và Shoulders Bạc Hà Mát Lạnh (850ml),Làm Đẹp - Sức Khỏe,189000,149000,53,4.8,40000,21
Sữa Rửa Mặt Dành Cho Da Mụn Innisfree Bija Trouble Facial Foam 150g - 131171093,Làm Đẹp - Sức Khỏe,210000,210000,279,4.6,0,0
Tinh Chất Dưỡng Trắng Da Chống Thâm Nám Melano CC Whitening Essence (20ml),Làm Đẹp - Sức Khỏe,350000,265000,68,4.5,85000,24
Kem Nền Lâu Trôi Superstay Long Lasting Full Coverage Foundation Maybelline New York 30ml,Làm Đẹp - Sức Khỏe,258000,219000,45,4.8,39000,15
Sữa rửa mặt dạng bùn Trà tràm – Naruko Tea Tree Purifying Clay Mask and Cleanser in 1 (120g),Làm Đẹp - Sức Khỏe,239000,159000,671,4.7,80000,33
Sữa Tắm Lifebuoy Bảo Vệ Vượt Trội Dạng Túi (850g) - 21166643,Làm Đẹp - Sức Khỏe,122500,107000,493,4.7,15500,13
Vớ y khoa gối JOBST Relief - Cơ bản điều hỗ trợ trị giãn tĩnh mạch chân ,Làm Đẹp - Sức Khỏe,700000,680000,0,0,20000,3
Hộp Khẩu Trang 3D Mask Unicharm Nhật Bản Ngăn Ngừa Khói Bụi Chống Ô Nhiễm (100 miếng),Làm Đẹp - Sức Khỏe,275000,272000,270,4.8,3000,1
"Bộ sản phẩm giảm dầu, giảm mụn ngừa thâm hiệu quả sau 12h La Roche-Posay Effaclar Duo+",Làm Đẹp - Sức Khỏe,455000,359000,338,4.7,96000,21
Máy rửa mặt Foreo LUNA MINI 3 - Loại bỏ bụi bẩn và cặn trang điểm chỉ trong 30s,Làm Đẹp - Sức Khỏe,3500000,2470000,335,4.8,1030000,29
Dầu Gội Pantene Ngăn Rụng Tóc (900ML),Làm Đẹp - Sức Khỏe,177000,142000,19,4.5,35000,20
Nước Cân Bằng Làm Sạch Dầu Nhờn Và Ngăn Ngừa Mụn Mamonde Pore Clean Toner (250ml) 110651163,Làm Đẹp - Sức Khỏe,360000,306000,264,4.5,54000,15
Sữa Rửa Mặt Dịu Nhẹ Cetaphil Gentle Skin Cleanser 500ml,Làm Đẹp - Sức Khỏe,290000,288000,58,5,2000,1
Bao cao su Durex Invisible Extra Thin Extra Lubricated 1 Hộp 10 Bao,Làm Đẹp - Sức Khỏe,247000,189000,6,5,58000,23
Combo 3 Kem Đánh Răng P/S: Bảo Vệ 123 Nha Đam - Mẫu Đơn (180g) + Than Hoạt Tính & Tre (180g) + 123 Trà Xanh (190g),Làm Đẹp - Sức Khỏe,96000,87000,398,4.7,9000,9
BÔNG TẨY TRANG 100% COTTON 3 LỚP MONKIDS 100 MIẾNG,Làm Đẹp - Sức Khỏe,100000,39000,800,5,61000,61
Kem Dưỡng Ẩm Tối Ưu Hada Labo Advanced Nourish Hyaluron Cream (50g),Làm Đẹp - Sức Khỏe,185000,145000,203,4.7,40000,22
Kem chống nắng dạng sữa lỏng nhẹ không nhờn rít La Roche-Posay Anthelios Shaka Fluid SPF 50+ 50ml,Làm Đẹp - Sức Khỏe,475000,425000,14,4.6,50000,11
Lăn Khử Mùi Scion - Nuskin,Làm Đẹp - Sức Khỏe,198000,87980,537,4.5,110020,56
Gel Dưỡng Thể Dịu Mát Trắng Da Vaseline Fresh & Fair 350ml,Làm Đẹp - Sức Khỏe,141000,112000,535,4.7,29000,21
Son Bút Chì 3 Trong 1 Cho Bờ Môi Mềm Mượt Mamonde Creamy Tint Color Balm Intense (2.5g),Làm Đẹp - Sức Khỏe,220000,149000,219,4.5,71000,32
Combo 10 Mặt Nạ Giấy Dưỡng Da Foodaholic Essential Mask 23g x10,Làm Đẹp - Sức Khỏe,250000,69000,206,4.8,181000,72
Sữa Dưỡng Thể Vaseline Perfect 10 Trong 1 32015363 (350ml),Làm Đẹp - Sức Khỏe,141000,112000,542,4.6,29000,21
Kem chống nắng dạng gel bảo vệ hoàn hảo Anessa Perfect UV Sunscreen Skincare Gel 90g,Làm Đẹp - Sức Khỏe,550000,384000,239,4.6,166000,30
Gel bôi trơn Durex Play Strawberry 100ml,Làm Đẹp - Sức Khỏe,194000,159000,0,0,35000,18
Sữa chống nắng nâng tông dành cho da dầu/hỗn hợp Sunplay Skin Aqua Tone Up UV Milk Lavender SPF50+ PA++++ (50g),Làm Đẹp - Sức Khỏe,175000,144000,89,4.8,31000,18
Bao cao su Durex Invisible Extra Thin Extra Sensitive 1 Hộp 3 Bao,Làm Đẹp - Sức Khỏe,89000,71000,5,5,18000,20
Combo 2 Nước Súc Miệng Hương Bạc Hà Listerine Cool Mint (750ml/Chai),Làm Đẹp - Sức Khỏe,272000,149000,552,4.8,123000,45
Gel rửa mặt tạo bọt làm sạch & giảm nhờn cho da dầu nhạy cảm La Roche-Posay Effaclar Purifying Foaming Gel (50ml),Làm Đẹp - Sức Khỏe,195000,168500,46,4.8,26500,14
Sữa Tắm Lifebuoy Chăm Sóc Da (1.1Kg),Làm Đẹp - Sức Khỏe,166500,141000,283,4.5,25500,15
Bao Cao Su Sagami Xtreme Super Thin (10 Cái / Hộp),Làm Đẹp - Sức Khỏe,150000,55500,112,4.8,94500,63
Nước tẩy trang dành cho da nhạy cảm La Roche Posay 50ml,Làm Đẹp - Sức Khỏe,110000,109500,5,4.6,500,0
Dung Dịch Làm Sạch Và Tẩy Trang Công Nghệ Micella Bioderma Sensibio H2O - 500ml,Làm Đẹp - Sức Khỏe,495000,445000,273,4.8,50000,10
Kem chống nắng dưỡng trắng dạng gel Anessa Whitening UV Sunscreen Gel 90g,Làm Đẹp - Sức Khỏe,550000,389000,259,4.7,161000,29
Cốc Luyện Tập Cho Nam TRAIL II công nghệ Nhật Bản,Làm Đẹp - Sức Khỏe,700000,225000,241,4.5,475000,68
Dầu gội đầu Head&Shoulders Clinical Strength Shampoo,Làm Đẹp - Sức Khỏe,400000,339000,93,4.8,61000,15
Bộ vòng đeo cho nam,Làm Đẹp - Sức Khỏe,140000,24000,300,4,116000,83
Gel bôi trơn Durex Play Warming 100ml,Làm Đẹp - Sức Khỏe,194000,159800,28,4.5,34200,18
Máy Rửa Mặt Và Mát Xa Da Mặt Halio Facial Cleansing & Massaging Device,Làm Đẹp - Sức Khỏe,810000,540000,1472,4.5,270000,33
Nước tẩy trang sạch thoáng Senka A.L.L.Clear Water Fresh 230ml,Làm Đẹp - Sức Khỏe,109000,79000,664,4.6,30000,28
Sữa Rửa Mặt Nam Ngăn Ngừa Mụn Sạch Nhờn Trắng Da Hàn Quốc Cao Cấp Dabo Black Force (120ml) – Hàng Chính Hãng,Làm Đẹp - Sức Khỏe,186000,96000,398,4.7,90000,48
Khăn Ướt Cực Đã Choice L (CL) (120 Miếng),Làm Đẹp - Sức Khỏe,25000,22000,296,4.8,3000,12
Máy Rung Vùng Kín Đa Chức Năng - 7 Kiểu Thụt - Đa Chế Độ Rung - Chất Liệu Silicone Mềm Mại,Làm Đẹp - Sức Khỏe,1300000,279000,13,4.7,1021000,79
"[[ Xuất Khẩu Mỹ ]] - COMBO 5 HỘP - Khẩu Trang Y Tế Cao Cấp FAMAPRO - 4 Lớp Kháng Khuẩn / 99% Lọc Khuẩn, Bụi, Virus Tốt Nhất / Người Lớn - [ CB5 - MAX - HỘP ]",Làm Đẹp - Sức Khỏe,300000,160000,121,4.8,140000,47
Bộ sản phẩm giảm mụn ngừa thâm siêu hiệu quả trong 12h La Roche-Posay,Làm Đẹp - Sức Khỏe,155000,139000,652,4.7,16000,10
Dầu Gội Chống Gàu Selsun (100ml),Làm Đẹp - Sức Khỏe,95000,84000,219,4.8,11000,12
Combo 10 Mặt nạ dưỡng ẩm trắng da giúp kiềm dầu và mụn Hàn Quốc Lagivado Hydra Calming Facial Mask 23g/miếng,Làm Đẹp - Sức Khỏe,350000,189000,411,4.7,161000,46
Combo Dầu Gội và Sữa tắm nước hoa Enchanteur Charming 650g/Chai,Làm Đẹp - Sức Khỏe,363000,238000,159,4.7,125000,34
Xịt Nano Tan Mỡ J.PLUS,Làm Đẹp - Sức Khỏe,289000,235000,3,5,54000,19
Bao cao su Durex Kingtex 3 bao,Làm Đẹp - Sức Khỏe,49000,39000,4,5,10000,20
Dung Dịch Loại Bỏ Tế Bào Chết 2% BHA Paula's Choice Skin Perfecting 2% BHA Liquid Exfoliant (118ml),Làm Đẹp - Sức Khỏe,910000,608000,19,4.6,302000,33
Dầu Gội Và Xả Hoa Bưởi Thorakao 400ml,Làm Đẹp - Sức Khỏe,89000,55000,349,4.6,34000,38
Nước Tẩy Trang Vitamin Và Hoa Hồng Sáng Da  Pond's Micellar Water,Làm Đẹp - Sức Khỏe,99000,87000,291,4.6,12000,12
Combo Dove Phục Hồi Hư Tổn Dầu Gội 640g + Kem Xả 610g,Làm Đẹp - Sức Khỏe,270000,226000,252,4.7,44000,16
Bộ sản phẩm dưỡng trắng da tối ưu Hada Labo Perfect White (Kem rửa mặt 80g + Dung dịch dưỡng 100ml + Kem dưỡng 50g),Làm Đẹp - Sức Khỏe,477000,339000,194,4.5,138000,29
Camera IP Wifi TP-Link Tapo C200 Full HD 1080P Giám sát An Ninh - Hàng Chính Hãng,Máy Ảnh - Máy Quay Phim,999000,499000,130,4.6,500000,50
Camera IP Wifi Ezviz C6N 1080p-Hàng Chính Hãng,Máy Ảnh - Máy Quay Phim,1200000,499000,1507,4.6,701000,58
Máy Ảnh Lấy Liền Fujifilm Instax Mini 11-Hàng Chính Hãng,Máy Ảnh - Máy Quay Phim,2290000,1690000,171,4.7,600000,26
Camera Wi-Fi TP-Link Tapo C200 1080P (2MP) An Ninh Gia Đình Có Thể Điều Chỉnh Hướng - Hàng Chính Hãng,Máy Ảnh - Máy Quay Phim,1229000,467000,81,4.8,762000,62
"Bộ 2 pin và sạc đôi RavPower NP-FW50 cho Sony A6000, A6300, A6500, A7, A7 II, A7R, A7S... - Hàng chính hãng",Máy Ảnh - Máy Quay Phim,1050000,569999,1,5,480001,46
Hộp Film Fujifilm Mini 20 Tấm - Hàng Chính Hãng,Máy Ảnh - Máy Quay Phim,500000,259000,588,4.8,241000,48
Camera wifi Yoosee chuẩn 3 râu 11 LED Full HD - hàng chính hãng,Máy Ảnh - Máy Quay Phim,1000000,358000,38,4.3,642000,64
[Chân chụp ảnh] Chân đế Tripod Bluetooth cho điện thoại và máy ảnh TTX - 6218 (Kèm túi đựng và remote bluetooth) - Hàng nhập khẩu,Máy Ảnh - Máy Quay Phim,450000,188000,3,5,262000,58
Bộ 2 pin sạc và Đốc sạc đôi KingMa NP-FW50 cho Sony A6000 A6300 A6500 - Hàng Chính Hãng,Máy Ảnh - Máy Quay Phim,790000,539999,1,5,250001,32
Camera Wifi thông minh EZVIZ C6N 1080P (CS-C6N-A0-1C2WFR) - TẶNG KÈM THẺ 32GB - HÀNG CHÍNH HÃNG,Máy Ảnh - Máy Quay Phim,1200000,595000,19,4.5,605000,50
Camera chống trộm Xiaomi Mi Home 360° 1080P 2019 QDJ4058GL - Hàng Chính Hãng,Máy Ảnh - Máy Quay Phim,899000,749000,18,4.1,150000,17
Máy Ảnh Canon EOS 3000D + Lens EF-S 18 - 55mm III (Lê Bảo Minh) - Hàng Chính hãng,Máy Ảnh - Máy Quay Phim,9900000,7590000,91,4.2,2310000,23
Túi máy ảnh đeo chéo Caden K11 Size XL - Hàng chính hãng,Máy Ảnh - Máy Quay Phim,800000,499999,8,5,300001,38
Camera IP Wifi Ngoài trời Yoosee GW-216S 2 Râu FullHD 1080P 6 LED trợ sáng đàm thoại 2 chiều (Trắng) Hàng Nhập Khẩu,Máy Ảnh - Máy Quay Phim,600000,476000,10,4.5,124000,21
Camera IP Wifi Ngoài Trời Ezviz C3X Bản Mắt Kép Có Màu Ban Đêm Full HD 1080P Tặng Phíc Cắm Âm - Hàng Chính Hãng,Máy Ảnh - Máy Quay Phim,2990000,1429000,61,4.5,1561000,52
Camera IP Ngoài Trời Chống Nước Ezviz C3WN 2Mp Full HD1080P - Hàng Chính Hãng,Máy Ảnh - Máy Quay Phim,1350000,780000,150,4.7,570000,42
Balo Canvas chống nước Profocus Haft foto,Máy Ảnh - Máy Quay Phim,990000,949999,1,4,40001,4
Camera IP Wifi Ezviz ECS-CV206 - Hàng chính hãng,Máy Ảnh - Máy Quay Phim,920000,360000,12,4.8,560000,61
Camera IP Wifi PTZ Ngoài Trời Ezviz C8C Full Color Hồng Ngoại 30 Mét Có Dây Nối Nguồn Dài 20M - Hàng Chính Hãng,Máy Ảnh - Máy Quay Phim,2980000,1390000,29,4.5,1590000,53
Camera IP Wifi Ezviz CS-CV246 - Hàng Chính Hãng,Máy Ảnh - Máy Quay Phim,1235000,499000,104,4.5,736000,60
Sạc đôi kèm cáp sạc và 2 pin sạc KingMa LP-E17 cho Canon EOS M3 M5 M6 760D 800D - Hàng chính hãng,Máy Ảnh - Máy Quay Phim,900000,548999,4,4.5,351001,39
Thẻ Nhớ SDXC Sandisk Extreme Pro 170MB/s V30 64GB - Hàng Nhập Khẩu,Máy Ảnh - Máy Quay Phim,690000,410000,434,4.7,280000,41
Vỉ 5 Viên Pin CR2032 Panasonic ( CR-2032/5BE x 1 Vỉ ) Lithium 3 V,Máy Ảnh - Máy Quay Phim,80000,55000,153,4.7,25000,31
"Chân Đế Camera Xoay 360 độ, chuyên dùng cho Camera Ezviz C6N Camera Imou A22Ep Camera Kbone H21PW",Máy Ảnh - Máy Quay Phim,99000,14900,22,4.6,84100,85
Ống Nhòm Barska Lucid 8x21mm - Hàng chính hãng,Máy Ảnh - Máy Quay Phim,800000,679000,13,4.2,121000,15
Camera chống trộm Xiaomi 360° 1080P Mi Home (Trắng) - Hàng Chính Hãng,Máy Ảnh - Máy Quay Phim,899000,718000,0,0,181000,20
Máy Ảnh Fujifilm X-A5 + lens 15-45mm F3.5-5.6 OIS (24.2MP) - Hàng Chính Hãng,Máy Ảnh - Máy Quay Phim,15990000,9990000,0,0,6000000,38
Camera wifi mini HD-720P V380 Model 2019,Máy Ảnh - Máy Quay Phim,700000,256938,0,0,443062,63
Bộ 2 Pin Và Sạc Kép RAVPower Cho FujiFilm NP-W126S X-A X-E X-H X-T X-M X-Pro Series - Hàng Nhập Khẩu,Máy Ảnh - Máy Quay Phim,715000,590999,3,4.3,124001,17
Tay Cầm Chống Rung Zhiyun SMOOTH 4 Dùng Cho Điện Thoại - Hàng Nhập Khẩu,Máy Ảnh - Máy Quay Phim,3190000,1699999,26,4.7,1490001,47
Hộp Film Fujifilm Mini 10 Tấm - Hàng Chính Hãng,Máy Ảnh - Máy Quay Phim,400000,190000,1,5,210000,53
"Bộ giá đỡ điện thoại, máy ảnh 3 chân tripod",Máy Ảnh - Máy Quay Phim,123000,60000,42,4.3,63000,51
Bộ 2 Pin Và Sạc Đôi Wasabi FW50 Cho Sony A7 A6000 A6300 A6500 - Hàng Nhập Khẩu,Máy Ảnh - Máy Quay Phim,792000,699999,1,4,92001,12
Camera IP Yoosee 3 râu 2.0 Full HD 1080p dùng phần mềm Yoosee bảo mật cao - Hàng Nhập Khẩu,Máy Ảnh - Máy Quay Phim,650000,325000,17,4.2,325000,50
Bộ Sạc Pin AA AAA + 4 Pin AA 1200mAh Doublepow (Hàng nhập khẩu),Máy Ảnh - Máy Quay Phim,250000,89000,47,4.3,161000,64
Tay cầm chống rung cho điện thoại Gimbal Zhiyun Smooth 4 - Chính hãng,Máy Ảnh - Máy Quay Phim,2100000,1690000,3,5,410000,20
Pin Cho Máy Ảnh Cho  Canon LP-E6 ,Máy Ảnh - Máy Quay Phim,399000,214999,1,5,184001,46
Camera IP WIFI IMOU RANGER 2 IPC - A22EP Full HD 1080P - Hàng Chính Hãng,Máy Ảnh - Máy Quay Phim,1150000,582000,24,4.8,568000,49
Ống Nhòm Một Mắt Tầm Nhìn 8000m - Hàng Nhập Khẩu,Máy Ảnh - Máy Quay Phim,280000,107000,14,4.5,173000,62
"Giá đỡ tripod 3 chân xoay ngang dọc hỗ trợ chụp ảnh, livestream nhẹ gọn tặng kèm đầu kẹp điện thoại 2 lỗ chắc chắn",Máy Ảnh - Máy Quay Phim,138000,69000,22,3.6,69000,50
Pin cho Canon LP-E12  cho Canon M10 100D Rebel S1 M M2 M50 M100,Máy Ảnh - Máy Quay Phim,299000,172999,5,4.6,126001,42
Chân Máy Ảnh Tripod Weifeng 3520 - Hàng Nhập Khẩu,Máy Ảnh - Máy Quay Phim,450000,298000,3,3.7,152000,34
Camera IP Wifi Ezviz C3WN 2Mp Full HD1080P (Camera Ngoài Trời) - Hàng Chính Hãng,Máy Ảnh - Máy Quay Phim,1350000,780000,3,4,570000,42
"Chân máy ảnh Tripod 3110 tặng Giá kẹp điện thoại, Remote bluetooth và Túi đựng",Máy Ảnh - Máy Quay Phim,290000,80000,63,4,210000,72
"Bộ 2 pin và đế sạc kép RAVPower RP-BC023 tương thích Fujifilm NP-W126S, FinePix X-A5,...  - Hàng Chính Hãng",Máy Ảnh - Máy Quay Phim,1250000,569999,0,0,680001,54
Camera IP Wifi Ngoài trời Yoosee PTZ 2 Râu FullHD 1080P 8 LED trợ sáng đàm thoại 2 chiều - hỗ trợ xoay 355 độ (Trắng) Hàng Nhập Khẩu,Máy Ảnh - Máy Quay Phim,900000,530000,13,4.5,370000,41
Camera Giám Sát IP Yoosee 3 Râu - Hàng nhập khẩu,Máy Ảnh - Máy Quay Phim,500000,328000,30,4.1,172000,34
Máy Ảnh Canon Powershot G7X Mark II – Đen – Hàng Chính Hãng,Máy Ảnh - Máy Quay Phim,18630000,10490000,29,4.6,8140000,44
Pin Wasabi FW50 For Sony A7 A6000 Nex E-Mount - Hàng Nhập Khẩu,Máy Ảnh - Máy Quay Phim,440000,300999,3,3.3,139001,32
Máy ảnh lấy liền Fujifilm Instax Mini LiPlay - Hàng chính hãng,Máy Ảnh - Máy Quay Phim,4190000,3590000,82,4.7,600000,14
Camera Hành Trình Mini DV SQ11 Full HD 1080P Hỗ Trợ Ban Đêm Cao Cấp AZONE,Máy Ảnh - Máy Quay Phim,485000,108500,22,3,376500,78
Máy Ảnh Fujifilm X-E3 + Lens 15-45mm Silver - Hàng Chính Hãng,Máy Ảnh - Máy Quay Phim,23990000,19990000,0,0,4000000,17
Ống Nhòm Một mắt Barska Lucid 10x25 - Hàng chính hãng,Máy Ảnh - Máy Quay Phim,800000,660000,2,3,140000,18
Gopro Hero 9 Black - Hàng Chính Hãng,Máy Ảnh - Máy Quay Phim,11990000,10499000,0,0,1491000,12
"Máy Ảnh Sony DSC H300 - 20.1 Megapixel, Zoom 35x - Hàng Chính Hãng",Máy Ảnh - Máy Quay Phim,4490000,3590000,150,4.1,900000,20
Camera IP Wifi Ezviz C6N CS-CV246 + Thẻ nhớ Ezviz 32GB - Hàng Chính Hãng,Máy Ảnh - Máy Quay Phim,1700000,597000,11,4.5,1103000,65
Pin cho máy ảnh Canon LP-E8 LPE8 pin máy ảnh Canon 550D 600D 650D 700D,Máy Ảnh - Máy Quay Phim,400000,172999,3,4,227001,57
Thẻ Nhớ SDHC SanDisk Extreme 90MB/s 32GB - Hàng Nhập Khẩu,Máy Ảnh - Máy Quay Phim,490000,195000,72,4.7,295000,60
Pin sạc AA Ni-MH dung lượng lớn 3300 mAh,Máy Ảnh - Máy Quay Phim,290000,119000,37,4.5,171000,59
Chân Đế Dùng Cho Máy Ảnh Điện Thoại Kiểu Mới Tripod TTX--6218 - Hàng Nhập Khẩu - Tặng kèm remote và túi đựng tiện lợi,Máy Ảnh - Máy Quay Phim,479000,189000,28,4.7,290000,61
Pin máy ảnh cho Sony NP-BX1 1350mAh,Máy Ảnh - Máy Quay Phim,300000,129999,5,5,170001,57
Máy Ảnh Canon EOS M200 KIT 15-45mm - Hàng Chính Hãng,Máy Ảnh - Máy Quay Phim,21990000,11190000,24,4.8,10800000,49
Tay cầm chống rung cho điện thoại DJI OM4 (Osmo Mobile 4) - Hàng chính hãng,Máy Ảnh - Máy Quay Phim,3250000,3178000,9,5,72000,2
"Ba Lô Máy Ảnh Cỡ Lớn, Dã Ngoại, Chống Nước, Bền Bỉ",Máy Ảnh - Máy Quay Phim,1199000,1049999,1,5,149001,12
Camera Wi-Fi TP-Link Tapo C200 1080P (2MP) Tặng Thẻ nhớ Adata 32gb - Hàng Chính Hãng,Máy Ảnh - Máy Quay Phim,1190000,599000,57,4.8,591000,50
CAMERA WIFI YOOSEE NGOÀI TRỜI C12 14 LED -HÀNG NHẬP KHẨU,Máy Ảnh - Máy Quay Phim,1590000,756000,8,4.5,834000,52
"Bộ đèn studio chụp ảnh sản phẩm, quay phim, livestream chuyên nghiệp, bộ gồm chân đèn 2m kèm softbox 50x70cm, tay treo 138 cm.",Máy Ảnh - Máy Quay Phim,600000,265000,0,0,335000,56
Pin NP-W126 cho máy ảnh Fujifilm,Máy Ảnh - Máy Quay Phim,550000,134999,7,5,415001,75
Chân Máy Ảnh Tripod WEIFENG WT-3520 - Hàng nhập khẩu,Máy Ảnh - Máy Quay Phim,399000,359000,3,4.7,40000,10
Thẻ Nhớ SDXC Sandisk Extreme 150MB/s 64GB - Hàng Nhập Khẩu,Máy Ảnh - Máy Quay Phim,499000,305000,133,4.8,194000,39
Tủ Chống Ẩm Andbon AB-30C (30 lít) - Hàng Nhập Khẩu,Máy Ảnh - Máy Quay Phim,2000000,1145000,9,4.5,855000,43
Pin Dành Cho Máy Ảnh Sony NP-FW50 1080mAh Cao Cấp AZONE,Máy Ảnh - Máy Quay Phim,345000,299999,0,0,45001,13
Camera IP Wifi IPC-A22EP-IMOU Chuẩn 1080P- Chính Hãng,Máy Ảnh - Máy Quay Phim,1320000,584000,28,4.1,736000,56
Camera an ninh giám sát trong nhà không dây WiFi 360 HeimVision HM203 1080P- Hàng chính hãng,Máy Ảnh - Máy Quay Phim,1900000,1900000,7,4.3,0,0
Camera Yoosee 3.0MPX - Thế hệ mới,Máy Ảnh - Máy Quay Phim,600000,420000,10,4.6,180000,30
Sạc pin máy ảnh Canon LP-E5 Canon EOS Rebel XS Rebel T1i Rebel XSi 1000D 500D 450D X3 Kiss X2 Kiss F LPE5,Máy Ảnh - Máy Quay Phim,200000,124999,2,4.5,75001,38
Camera IP Xiaomi MJSXJ02CM Mi Home Security Camera 360 Độ 1080p - Hàng Chính Hãng,Máy Ảnh - Máy Quay Phim,890000,790000,3,3.3,100000,11
Bộ 4 Viên Pin Tiểu Sạc AA Cao Cấp 1200mAh Doublepow - Hàng nhập khẩu,Máy Ảnh - Máy Quay Phim,150000,59000,28,4.8,91000,61
camera wifi yoosee ngoài trời 1080p 4 râu kèm thẻ 64gb - camera ip yoosee 3.0mp ngoài trời chống nước có mầu ban đêm - hàng nhập khẩu,Máy Ảnh - Máy Quay Phim,800000,800000,12,3.5,0,0
Balo Canvas chống nước nắp da bò Pretty boy backpack size ,Máy Ảnh - Máy Quay Phim,1299000,989999,0,0,309001,24
Combo Túi + Chân Gimbal DJI Osmo Mobile 3 - Hàng Nhập Khẩu,Máy Ảnh - Máy Quay Phim,3790000,2801500,9,5,988500,26
Thẻ Nhớ SDXC Sandisk Extreme Pro 170MB/s V30 128GB - Hàng Nhập Khẩu,Máy Ảnh - Máy Quay Phim,1100000,710000,76,4.8,390000,35
"Camera Mini IP Vstarcam CB73 2.0 WiFi 1080P Giám Sát Hành Trình Ô Tô, Nhỏ Gọn, Dễ Dàng Cài Đặt, Bảo Mật Cao, Chống Chộm, Xem Trực Tiếp Từ Xa Bằng Điện Thoại, PC, iPad - Hàng Chính Hãng",Máy Ảnh - Máy Quay Phim,1690000,549000,77,3.8,1141000,68
Pin Wasabi NP-W126 Cho Fujifilm X-E1 X-A2 X-M1 X-T1 (Đen) -  Hàng Nhập Khẩu,Máy Ảnh - Máy Quay Phim,570000,349999,0,0,220001,39
"Tripod giá đỡ 3 chân mini đa năng hỗ trợ tay cầm, để bàn cho điện thoại, gopro ",Máy Ảnh - Máy Quay Phim,90000,69000,86,4.3,21000,23
Camera Ip wifi Yoosee HD720P quay quét 360 nhập khẩu ,Máy Ảnh - Máy Quay Phim,550000,309000,16,4.2,241000,44
Giá đỡ 3 chân Selfie Tripod 3110 Cho điện thoại và máy ảnh tặng kèm túi vải cá tính,Máy Ảnh - Máy Quay Phim,299000,99000,6,4.5,200000,67
"Camera Mini IP Vstarcam CB72 1080P 2.0 Sim 4G LTE Giám Sát Hành Trình Ô Tô, Xem Trực Tiếp Từ Xa Bằng Điện Thoại, PC - Hàng Chính Hãng",Máy Ảnh - Máy Quay Phim,4500000,1980000,4,3.3,2520000,56
"Flycam SJRC F11 4K PRO ( F11S ), Camera 4K, Chống rung 2 trục, Thời gian bay lên tới 25 phút - Hàng chính hãng",Máy Ảnh - Máy Quay Phim,6500000,3590000,8,4.5,2910000,45
Camera IP Wifi Ezviz C2C (Ezviz Mini O CS-CV206) - Hàng Chính Hãng,Máy Ảnh - Máy Quay Phim,1120000,356000,4,5,764000,68
Mic Thu Âm Cho Điện Thoại Và Máy Ảnh BOYA BY-M1 - Hàng Chính Hãng,Máy Ảnh - Máy Quay Phim,600000,249999,11,4.5,350001,58
"Ống Nhòm Quân Sự Barska Deep Sea 7x50 (chống nước,  mờ sương, có la bàn,vạch ly giác) - Hàng chính hãng",Máy Ảnh - Máy Quay Phim,9000000,7900000,0,0,1100000,12
Camera IP Wifi Ezviz C6CN 720P (CS-CV246-B0-1C1WFR) - Hàng Chính Hãng,Máy Ảnh - Máy Quay Phim,1230000,499000,32,4.3,731000,59
Camera Ip Wifi Ngoài Trời Yoosee GW-218S - 4 Râu Bắt Wifi Cự Mạnh  Full HD 1080P - Có Màu Ban Đêm - Hàng Chính Hãng,Máy Ảnh - Máy Quay Phim,999000,780000,0,0,219000,22
"Dụng Cụ Lấy Ráy Tai Thông Minh, Camera Nội Soi Lấy Ráy Tai INTELLHAWK - HÀNG CHÍNH HÃNG, Kèm Bộ Đầu Lấy Ráy Tai, Soi Tai Mũi Họng Chuyên Nghiệp",Máy Ảnh - Máy Quay Phim,329000,108777,3,3,220223,67
Ống nhòm Barska Lucid View 10x42mm New - Hàng chính hãng,Máy Ảnh - Máy Quay Phim,3500000,2212000,1,5,1288000,37
CAMERA WIFI IP EZVIZ C1C CS-C1C-D0-1D2WFR 1080P Full HD - HÀNG CHÍNH HÃNG,Máy Ảnh - Máy Quay Phim,1020000,519000,1,5,501000,49
Camera IP WIFI EZVIZ CS-C1C-D0-1D1WFR 720P - HÀNG CHÍNH HÃNG,Máy Ảnh - Máy Quay Phim,680000,395000,2,4.5,285000,42
"Máy bay điều khiển từ xa, Flycam điều khiển giá rẻ XT-1",Máy Ảnh - Máy Quay Phim,2387000,849990,0,0,1537010,64
Túi đựng máy ảnh vải Caravan da chống thấm nước DG079,Máy Ảnh - Máy Quay Phim,1250000,889999,0,0,360001,29
Camera wifi mini không dây Full HD 1080P có báo động chống trộm,Máy Ảnh - Máy Quay Phim,600000,315000,28,3.4,285000,48
"Máy bay điều khiển từ xa 4 cánh, máy bay Flycam, máy bay camera Selfie trên cao (KHÔNG GỒM CAMERA)",Máy Ảnh - Máy Quay Phim,550000,399000,60,3.7,151000,27
Gopro HERO 8 - Hàng chính hãng,Máy Ảnh - Máy Quay Phim,10499000,7490000,2,5,3009000,29
 Sạc Pin Máy Ảnh For Nikon EN-EL15,Máy Ảnh - Máy Quay Phim,179000,108999,1,4,70001,39
Máy in ảnh Mini Canon PV-123 Xám-Hàng chính hãng,Máy Ảnh - Máy Quay Phim,3300000,1090000,35,4.5,2210000,67
Máy Ảnh Selfie Lấy Liền Fujifilm Instax Mini 9 Clear Purple - Hàng Chính Hãng,Máy Ảnh - Máy Quay Phim,1990000,1499000,11,4.6,491000,25
Máy Ảnh Fujifilm X-T30 + Lens 18-55mm - Hàng Chính Hãng,Máy Ảnh - Máy Quay Phim,31990000,26790000,49,4,5200000,16
Sạc đôi kèm cáp sạc và 2 pin sạc KingMa LP-E17 cho Canon EOS M3 M5 M6 760D 800D - Hàng chính hãng,Máy Ảnh - Máy Quay Phim,900000,548999,4,4.5,351001,39
Bộ sạc và pin PANASONIC Eneloop CC51E ( 2 viên AA 2000mAh) - Hàng chính hãng,Máy Ảnh - Máy Quay Phim,580000,449000,12,4.7,131000,23
"Camera IP EZVIZ C6N 1080p Smart IR 2.0 Megapixel, hồng ngoại thông minh, theo dõi chuyển động - Hàng Chính Hãng",Máy Ảnh - Máy Quay Phim,850000,504000,3,5,346000,41
"Kèm túi đựng - Máy bay Flycam Teng mini KF609, Camera 4K, nhận diện cử chỉ, gấp gọn kết nối trực tiếp điện thoại",Máy Ảnh - Máy Quay Phim,1450000,830000,21,4.1,620000,43
 Pin Máy Ảnh cho  Nikon EN-EL15 - Hàng Nhập Khẩu,Máy Ảnh - Máy Quay Phim,599000,261999,5,3,337001,56
Camera IP Wifi Ngoài Trời Imou F22P Bullet 2C Full HD 1080P Tặng Phíc Cắm Âm - Hàng Chính Hãng,Máy Ảnh - Máy Quay Phim,1900000,743900,1,5,1156100,61
"Camera wifi ngoài trời xoay 360 chống nước CARECAM CC8031 Bản Nâng Cấp Của 20HS, 3.0 MPx 1080P có kết nối máy tính, smart TV, Hàng nhập khẩu ",Máy Ảnh - Máy Quay Phim,859000,549000,2,4,310000,36
Chân Máy Ảnh Benro T880 EX (Tripod) - Hàng Chính Hãng,Máy Ảnh - Máy Quay Phim,650000,650000,3,4.3,0,0
Camera IP Wifi Yoosee Full HD 1080P 2.0 MP - Hàng Nhập Khẩu (new model),Máy Ảnh - Máy Quay Phim,699000,318000,8,3.8,381000,55
Camera mini Wifi Góc Rộng HD V380 E06,Máy Ảnh - Máy Quay Phim,800000,310000,18,4.1,490000,61
Chân Đế Camera Xoay 360 Bộ 2 Cái Phù Hợp Với Camera Ezviz C6N Camera Imou A22Ep Camera Kbone H21PW,Máy Ảnh - Máy Quay Phim,168000,32300,5,5,135700,81
Camera hành trình 70mai Dash Cam Pro Plus A500 bản quốc tế - Hàng chính hãng,Máy Ảnh - Máy Quay Phim,1999000,1559000,33,4.5,440000,22
Vỏ Chống Nước Telesin Cho GoPro Hero 9  - Case  Action Camera Bảo Vệ Máy Quay Hành Trình GoPro (Hàng Chính Hãng),Máy Ảnh - Máy Quay Phim,350000,249000,40,4.8,101000,29
"Camera IP - Camera Wifi Quan Sát CC8031 Ngoài Trời Đàm Thoại 2 Chiều 3.0Mpx 2304x1296P, Xoay 360 Độ Kèm Thẻ Nhớ 32Gb - Chính Hãng",Máy Ảnh - Máy Quay Phim,1240000,649000,10,3.5,591000,48
Camera ip wifi mini V380 Pro - Hỗ trợ xem hồng ngoại ban đêm,Máy Ảnh - Máy Quay Phim,500000,306000,13,4.5,194000,39
Ống Nhòm Du Lịch 2 Mắt Chuyên Dụng Xuyên Đêm Ống Nhòm Galileo 20x50 Góc Nhìn Rộng Hàng Nhập Khẩu,Máy Ảnh - Máy Quay Phim,696968,278300,0,0,418668,60
Hạt Hút Ẩm Xanh Cho Máy Ảnh Kèm Túi Đựng (Silica Gel),Máy Ảnh - Máy Quay Phim,200000,127000,57,4.6,73000,37
Sạc pin máy ảnh Canon LP-E5 Canon EOS Rebel XS Rebel T1i Rebel XSi 1000D 500D 450D X3 Kiss X2 Kiss F LPE5,Máy Ảnh - Máy Quay Phim,200000,124999,2,4.5,75001,38
"Bộ 2 Pin + Sạc Đôi RAVPower Fujifilm NP-W126S Cho Fujifilm X-T20, X-T10, X-T100, X100F, X-H1, X-T3, X-T2, X-T1, X-A5, X-A3, X-A1, X-E1, X-E2,... (Hàng Chính Hãng)",Máy Ảnh - Máy Quay Phim,1590000,569000,29,5,1021000,64
Chân đế Tripod cho điện thoại và máy ảnh 3366 cao cấp - Tặng kèm remote Bluetooth  - Hàng nhập khẩu,Máy Ảnh - Máy Quay Phim,550000,215000,21,4.8,335000,61
Camera chống trộm Xiaomi 360° 1080P Mi Home (Trắng) - Hàng Nhập Khẩu,Máy Ảnh - Máy Quay Phim,899000,849000,1,5,50000,6
"Camera IP Ngoài trời Yoosee PTZ 2 Râu FullHD 1080P 6 LED trợ sáng, 4 LED hồng ngoại, đàm thoại 2 chiều, hỗ trợ xoay 360 (trắng) Hàng Nhập Khẩu",Máy Ảnh - Máy Quay Phim,1000000,536000,9,4.1,464000,46
Camera IP Wifi Ngoài Trời Yoosee 1080P - Ban Đêm Có Màu - Đàm Thoại 2 Chiều - Hàng Nhập Khẩu,Máy Ảnh - Máy Quay Phim,699000,468000,1,4,231000,33
"Giá đỡ điện thoại, máy ảnh 3 chân Tripod 3110 ",Máy Ảnh - Máy Quay Phim,123000,65000,35,4.2,58000,47
Camera IP wifi KBVISION trong nhà - xoay 360 độ - nghe nói 2 chiều KBONE H21PW - Hàng chính hãng,Máy Ảnh - Máy Quay Phim,1390000,565000,4,4.5,825000,59
Lens Sony E PZ 18–105 mm F4 G OSS - Hàng Chính Hãng,Máy Ảnh - Máy Quay Phim,12990000,12990000,1,5,0,0
Máy Ảnh Fujifilm X-A7 + Lens 15-45mm - Hàng Chính Hãng,Máy Ảnh - Máy Quay Phim,15990000,12990000,51,4.3,3000000,19
Bộ Phụ Kiện 50 in 1 cho GOPRO Hộp Đựng Cao Cấp Tặng Kèm Phao Nổi - Black,Máy Ảnh - Máy Quay Phim,599000,419000,34,4.2,180000,30
"Gói hút ẩm Silicagel loại 5gram (1kg có 200 gói nhỏ kích thước 5x5,5cm)",Máy Ảnh - Máy Quay Phim,150000,95000,59,4.8,55000,37
Máy Ảnh Lấy Liền Fujifilm Instax Square SQ20 - Hàng Chính Hãng,Máy Ảnh - Máy Quay Phim,5390000,4250000,1,5,1140000,21
Camera Wifi Ezviz C1C CS-C1C-E0-1E2WF 1080P - Hàng Chính Hãng,Máy Ảnh - Máy Quay Phim,990000,499000,4,3.5,491000,50
Camera Dahua IP Wifi  Imou IPC-C22EP-imou - Hàng chính hãng,Máy Ảnh - Máy Quay Phim,1160000,474000,1,5,686000,59
Bộ tripod chân chụp ảnh 3120 giá đỡ điện thoại - giá đỡ 3 Chân Tripod 3110 105cm Chuyên Chụp Hình Live Stream - giá đỡ điện thoại 3 chân máy ảnh gậy tự sướng ( MẦU ĐEN ),Máy Ảnh - Máy Quay Phim,140000,79000,14,3.9,61000,44
Camera IP Wifi 2.0MP KBONE KN-H21PW- HÀNG CHÍNH HÃNG,Máy Ảnh - Máy Quay Phim,1320000,580000,6,5,740000,56
Thẻ Nhớ SD SanDisk Ultra Class 10 32GB - 48MB/s - Hàng Chính Hãng,Máy Ảnh - Máy Quay Phim,500000,159000,25,4.5,341000,68
"Camera Wifi Quan Sát Ngoài Trời Chống Nước, Kết Nối Wifi Độ Phân Giải 2.0Mpx FULL HD 1920x1080, Xoay 360 Độ Model CC8021 PRO Dùng Ứng Dụng CARECAM RPO Nâng Cấp - Chính Hãng",Máy Ảnh - Máy Quay Phim,950000,529000,0,0,421000,44
Camera wifi yoosee 3.0  2K siêu nét - camera ip yoosee 3 râu 3mp trong nhà - hàng nhập khẩu,Máy Ảnh - Máy Quay Phim,750000,419000,9,3.6,331000,44
"Combo hộp chống ẩm máy ảnh và ẩm kế điện tử, 100gram hạt hút ẩm xanh - dung tích 4 lít (tặng mút xốp lót hộp)",Máy Ảnh - Máy Quay Phim,220000,169000,179,4.5,51000,23
"Bộ 2 pin và sạc đôi RavPower LP-E17 cho Canon 77D, 750D, 760D, 800D, M6 - Hàng chính hãng",Máy Ảnh - Máy Quay Phim,2000000,560000,20,5,1440000,72
"Feiyu Vimbal One - Gimbal Chống Rung Dùng Cho Điện Thoại, Trục Đơn 18cm Có Thể Mở Rộng Và Gập Gọn |  Feiyu Tech Vimble ONE Single Axis 18cm Extendable & Foldable Smartphone Gimbal Stabilizer - Hàng Chính Hãng",Máy Ảnh - Máy Quay Phim,1590000,649000,10,4,941000,59
"Camera Ip Quan Sát Trong Nhà, Độ Phân Giải Full HD 1920*1080P 2.0Mpx, Xoay Ngang 360 Độ, Xem Cùng Lúc 4 Camera, Hàng Chính Hãng",Máy Ảnh - Máy Quay Phim,700000,344000,0,0,356000,51
"Bộ 2 pin và sạc đôi RavPower NP-FW50 cho Sony A6000, A6300, A6500, A7, A7 II, A7R, A7S... - Hàng chính hãng",Máy Ảnh - Máy Quay Phim,1050000,569000,71,4.6,481000,46
Camera IP Wifi EZVIZ C3W 720P (CS-CV310) + Tặng thẻ nhớ EZVIZ 32GB - Hàng chính hãng,Máy Ảnh - Máy Quay Phim,2355000,799000,4,5,1556000,66
"Camera Wifi Ip Quan Sát Ngoài Trời Chống Nước, Ban Đêm Có Màu, Độ Phân Giải 3.0MPX, Xoay 360 Độ CC8031 - Nhập Khẩu",Máy Ảnh - Máy Quay Phim,1200000,620000,0,0,580000,48
Thẻ Nhớ SDHC Sandisk Extreme Pro 95MB/s 32GB - Hàng Nhập Khẩu,Máy Ảnh - Máy Quay Phim,350000,265000,128,4.6,85000,24
Camera IP Wifi IPC-A22EP-IMOU Chuẩn 1080P Tặng Thẻ nhớ Adata 32gb - Chính Hãng,Máy Ảnh - Máy Quay Phim,1490000,650000,2,4,840000,56
Chân đế mini- thiết bị ổn định cầm tay cho máy ảnh và điện thoại,Máy Ảnh - Máy Quay Phim,149000,89000,2,3,60000,40
Camera IP Wifi Ngoài Trời Ezviz C3N Full HD 1080p Có Màu Ban Đêm Tặng Phíc Cắm Âm - Hàng Chính Hãng,Máy Ảnh - Máy Quay Phim,2100000,900000,5,4.6,1200000,57
Thẻ Nhớ SD SanDisk 16GB Class 4 - Hàng Nhập Khẩu,Máy Ảnh - Máy Quay Phim,135000,99000,66,4.5,36000,27
"CAMERA WIFI NGOÀI TRỜI EVKVO YOOSEE D26S 24 LED ,NHÌN ĐÊM HỒNG NGOẠI, TẦM NHÌN BAN ĐÊM ĐẦY MÀU SẮC-HÀNG NHẬP KHẨU",Máy Ảnh - Máy Quay Phim,1800000,584000,8,4.1,1216000,68
Camera hành trình sports Eken HR9 Ultra HD Wifi quay video 4K tặng đầy đủ bộ phụ kiện lắp đặt trên cả ô tô xe máy - Hàng nhập khẩu nguyên bộ,Máy Ảnh - Máy Quay Phim,1680000,1041248,1,1,638752,38
Camera Wifi Ngoài Trời Ezviz C3W 2MP 1080p (CS-Cv310) Color Night Vision - Phiên Bản Mới Hình Ảnh Có Màu Ban Đêm - Hàng Chính Hãng,Máy Ảnh - Máy Quay Phim,1550000,1250000,2,4.5,300000,19
Camera IP Wifi Yoosee Full HD 1080P - Hàng Nhập Khẩu,Máy Ảnh - Máy Quay Phim,800000,326000,1,2,474000,59
Camera wifi IP app YOOSEE 3 râu bắt sóng mạnh hình ảnh HD 720P  thích hợp dùng trong nhà có thể xem được mọi lúc mọi nơi-Hàng chính hãng,Máy Ảnh - Máy Quay Phim,540000,316000,12,4.5,224000,41
Lens Canon 50mm f/1.8 STM (Lê Bảo Minh) - Hàng Chính Hãng,Máy Ảnh - Máy Quay Phim,2990000,2990000,370,4.5,0,0
Giá đỡ 3 Chân Tripod 3110 G1 105cm Chuyên Chụp Hình Live Stream - giá đỡ điện thoại 3 chân - giá đỡ máy ảnh - gậy tự sướng selfie ( mầu bạc ),Máy Ảnh - Máy Quay Phim,130000,62000,8,4.8,68000,52
"Hộp Đựng Chống Sốc Cho Tay cầm Chống Rung Smooth 4, Gimbal Vimble 2 DJI OSMO",Máy Ảnh - Máy Quay Phim,350000,188000,36,4.6,162000,46
Camera hành trình Full HD cho phượt thủ Sport Cam A9,Máy Ảnh - Máy Quay Phim,850000,445000,1,1,405000,48
Camera IP V380 Wifi Quan Sát Chống Trộm Chuẩn HD,Máy Ảnh - Máy Quay Phim,950000,258351,3,4,691649,73
Micro Thu Âm Đa Năng BOYA BY-MM1 - Hàng Chính Hãng,Máy Ảnh - Máy Quay Phim,847000,529000,25,4.5,318000,38
Dây cáp kết nối máy ảnh Canon với máy tính,Máy Ảnh - Máy Quay Phim,199000,79000,19,4.5,120000,60
 Camera Wifi Ngoài Trời_  Ceracam IP An Ninh -DK200-SF 2.0MPx Full HD- Phiên Bản Nâng Cấp Yoosee- Hàng Nhập Khẩu,Máy Ảnh - Máy Quay Phim,890000,468000,3,4.7,422000,47
"Camera Ip Wifi Quan Sát Trong Nhà Model CC1021 Xoay 360 Độ, Độ Phân Giải 2.0Mpx, Hỗ Trợ Đàm Thoại 2 Chiều, Tích Hợp Đèn Hồng Ngoại - Chính Hãng",Máy Ảnh - Máy Quay Phim,700000,324000,0,0,376000,54
Camera IP EZVIZ C6N 2MP 1080p Smart Night Vision - Tặng Thẻ Nhớ NETAC 32GB - Hàng Chính Hãng,Máy Ảnh - Máy Quay Phim,990000,597000,17,4.2,393000,40
"Chân máy ảnh Tripod 3120 tặng Giá kẹp điện thoại, Remote - Hàng Nhập Khẩu",Máy Ảnh - Máy Quay Phim,160000,92500,22,4,67500,42
Hộp chụp sản phẩm 40cm x 40cm tích hợp 4 dây đèn Led phông nền 6 màu,Máy Ảnh - Máy Quay Phim,649000,520000,28,4.5,129000,20
CẨM NANG MUA BÁN NHÀ,Sách,198000,150000,47,4.6,48000,24
Biên Niên Cô Đơn,Sách,99000,19800,1805,4.7,79200,80
Từ Điển Tiếng “Em”,Sách,69000,42800,3585,4.7,26200,38
Thay Đổi Cuộc Sống Với Nhân Số Học,Sách,248000,173600,1763,4.8,74400,30
Đọc Để Trưởng Thành - Tuyển Chọn Những Cuốn Sách Hay Dành Cho Bạn Trẻ (Hộp 5 Cuốn) - Tặng Kèm Sổ Độc Quyền (Số Lượng Có Hạn),Sách,480000,360000,0,0,120000,25
Cây Cam Ngọt Của Tôi,Sách,108000,98000,8,5,10000,9
"Cân Bằng Cảm Xúc, Cả Lúc Bão Giông",Sách,96000,64200,2420,4.7,31800,33
Vui Vẻ Không Quạu Nha - Tản Văn,Sách,69000,45100,235,4.5,23900,35
Sách Tài Chính Cá Nhân Cho Người Việt Nam - Tặng Khóa học Online về Tài chính,Sách,200000,200000,1104,4.7,0,0
Máy Tính Khoa Học Casio FX-580VN X,Sách,650000,561000,3897,4.8,89000,14
Một Cuốn Sách Buồn… Cười - Vui Vẻ Không Quạu Nha 2,Sách,79000,61000,136,4.8,18000,23
Tô Bình Yên Vẽ Hạnh Phúc,Sách,78000,54400,5876,5,23600,30
Nghệ Thuật Đánh Cắp Ý Tưởng (10 Bí Mật Không Ai Nói Với Bạn Về Sáng Tạo),Sách,99000,84150,14,4.2,14850,15
"Nóng Giận Là Bản Năng , Tĩnh Lặng Là Bản Lĩnh",Sách,89000,56700,3235,4.7,32300,36
Kiếp Nào Ta Cũng Tìm Thấy Nhau,Sách,85000,52800,1165,4.8,32200,38
Đàn Ông Sao Hỏa Đàn Bà Sao Kim,Sách,188000,119900,1961,4.7,68100,36
SÁCH VĂN HỌC THIẾU NHI_COMBO CUỘC SỐNG BAO ĐIỀU HAY 1+2+3,Sách,267000,230000,0,0,37000,14
Đời Ngắn Đừng Ngủ Dài (Tái Bản),Sách,75000,45000,1682,4.8,30000,40
Đắc Nhân Tâm (Khổ Lớn),Sách,76000,51600,184,4.8,24400,32
Con Chim Xanh Biếc Bay Về (Nguyễn Nhật Ánh) (Bìa Mềm),Sách,150000,75000,2735,5,75000,50
SÁCH VĂN HỌC THIẾU NHI_COMBO CHUYỆN MÈO MUN TÌM MẸ VÀ NHỮNG ÁNH SAO ĐÊM + TÌNH BẠN TUYỆT VỜI CỦA BELLA VÀ HAI CHÚ CHÓ MONKEY - RABBIT,Sách,126000,105000,2,4.5,21000,17
Đừng Lựa Chọn An Nhàn Khi Còn Trẻ,Sách,81000,56100,4741,4.7,24900,31
Đừng Làm Việc Chăm Chỉ Hãy Làm Việc Thông Minh,Sách,165000,106700,742,4.8,58300,35
How Psychology Works - Hiểu Hết Về Tâm Lý Học,Sách,300000,224900,352,4.7,75100,25
CẨM NANG MUA BÁN ĐẤT,Sách,198000,150000,61,4.5,48000,24
Combo 999 Lá Thư Gửi Cho Chính Mình - Tặng kèm bookmark (Trọn bộ 2 tập),Sách,198000,132600,1962,4.8,65400,33
Sapiens: Lược Sử Loài Người (Tái Bản Có Chỉnh Sửa) ,Sách,209000,167000,394,5,42000,20
Thiết Kế Cuộc Đời Thịnh Vượng - Design a Prosperous Life,Sách,299000,299000,1614,5,0,0
NYM - Tôi Của Tương Lai (Bản Đặc Biệt),Sách,390000,195000,117,5,195000,50
Chiến Binh Cầu Vồng (Tái Bản 2020),Sách,109000,76200,851,4.8,32800,30
Payback Time - Ngày Đòi Nợ,Sách,299000,299000,1701,4.8,0,0
Combo 2 Cuốn: Tâm Lý Học Tội Phạm,Sách,288000,215900,243,4.8,72100,25
Đừng Để Mất Bò - 7 Bước Quản Lý Cửa Hàng Hiệu Quả Và Chống Thất Thoát,Sách,169000,149000,344,5,20000,12
Bước Chậm Lại Giữa Thế Gian Vội Vã (Tái Bản),Sách,85000,83000,3,5,2000,2
OSHO - Yêu - Being In Love,Sách,168000,130800,452,5,37200,22
Nhà Giả Kim (Tái Bản 2020),Sách,79000,53200,1216,4.8,25800,33
Lâu Đài Bay Của Pháp Sư Howl (Tái Bản 2020),Sách,106000,78300,533,4.8,27700,26
Thám Tử Lừng Danh Conan - Tập 98,Sách,20000,15800,1280,5,4200,21
Giải Thích Ngữ Pháp Tiếng Anh (Tái Bản 2020),Sách,180000,103600,1247,4.8,76400,42
Đọc Vị Bất Kỳ Ai (Tái Bản 2019),Sách,79000,48800,1217,4.8,30200,38
Tài Chính Doanh Nghiệp - Corporate Finance,Sách,659000,620000,102,4.5,39000,6
Hiểu Về Trái Tim (Tái Bản),Sách,138000,102800,1143,4.8,35200,26
Mắt Biếc (Tái Bản 2019),Sách,110000,44000,2311,4.8,66000,60
Muôn Kiếp Nhân Sinh (Many Lives - Many Times),Sách,168000,67200,2734,4.7,100800,60
Sách: Thoát Khỏi Tâm Trí và Bước Vào Cuộc Sống,Sách,155000,116250,6,4.8,38750,25
Nhà Giả Kim,Sách,69000,55100,5512,4.7,13900,20
Spy X Family Tập 4,Sách,25000,22400,155,5,2600,10
Tâm Lý Học Về Tiền,Sách,189000,141750,119,4.8,47250,25
Giấy photo A4 70 Thiên Long PP-001,Sách,76300,65000,22,5,11300,15
Muôn Kiếp Nhân Sinh (Khổ Nhỏ),Sách,98000,58800,1162,4.8,39200,40
Tony Buổi Sáng - Trên Đường Băng (Tái Bản 2017),Sách,80000,40000,2211,4.8,40000,50
Tự Học 2000 Từ Vựng Tiếng Anh Theo Chủ Đề,Sách,65000,26000,1711,4.7,39000,60
Khi Nói Không Tôi Thấy Tội Lỗi,Sách,160000,120000,0,0,40000,25
Rèn Luyện Tư Duy Phản Biện,Sách,99000,74250,447,4.6,24750,25
Siêu Cò – How To Be A Power Connector,Sách,249000,249000,1453,4.8,0,0
Chuyện Lạ Ở Bệnh Viện Tư Nhân Hiệp Tế Đường Đồng Hoa Trung,Sách,149000,135000,0,0,14000,9
Combo Sách: Thai Giáo Theo Chuy​ên Gia  + Bách Khoa Nuôi Dạy Trẻ Từ 0-3 Tuổi,Sách,181000,135750,0,0,45250,25
Không Sợ Chậm Chỉ Sợ Dừng ,Sách,129000,102400,1293,5,26600,21
Tư Duy Sâu,Sách,91000,62600,576,4.8,28400,31
Bút lông 36 màu Fiber Pen Washable - Nét mảnh nét to - Colokit SWM-C006,Sách,160000,99000,147,4.8,61000,38
Ứng Dụng Siêu Trí Nhớ 4000 Từ Vựng Tiếng Anh Thông Dụng Nhất,Sách,119000,53550,65,4.6,65450,55
Dạy Con Làm Giàu (Tập 1) - Để Không Có Tiền Vẫn Tạo Ra Tiền - Cha Giàu Cha Nghèo (Tái Bản),Sách,65000,32500,1239,4.8,32500,50
Những Gì Đã Qua Đừng Nghĩ Lại Quá Nhiều (Tái Bản 2020)(Tặng Kèm 01 Bookmark),Sách,72000,46700,1295,4.7,25300,35
999 Lá Thư Gửi Cho Chính Mình – Mong Bạn Trở Thành Phiên Bản Hoàn Hảo Nhất,Sách,99000,67400,2294,4.7,31600,32
Vụ Án Mạng Ở Nhà Khách Núi Hakuba,Sách,138000,84100,204,4.8,53900,39
Những Tù Nhân Của Địa Lý,Sách,210000,159500,476,4.8,50500,24
Nhà Đầu Tư Thông Minh (Tái Bản 2020),Sách,199000,145200,796,4.7,53800,27
Yêu Những Điều Không Hoàn Hảo,Sách,139000,105500,1204,4.8,33500,24
PENBOOK - Luyện đề thi Tốt nghiệp THPT Môn Toán - 2021,Sách,225000,180000,8,5,45000,20
Mình Chỉ Là Người Bình Thường (Sách Tô Màu),Sách,138000,103400,89,4.7,34600,25
Sống Thực Tế Giữa Đời Thực Dụng,Sách,98000,65600,2356,4.7,32400,33
Hành Trình Về Phương Đông (Tái Bản 2019),Sách,88000,44000,1416,4.7,44000,50
COMBO VĂN HỌC TUỔI TEEN - Ơ KÌA TUỔI THƠ - TÌNH BẠN TUYỆT VỜI CỦA BELLA VÀ HAI CHÚ CHÓ MONKEY-RABBIT,Sách,156000,134000,2,5,22000,14
"Không Phải Chưa Đủ Năng Lực , Mà Là Chưa Đủ Kiên Định",Sách,71000,46200,1145,4.7,24800,35
Bạn Đắt Giá Bao Nhiêu?,Sách,99000,64200,2591,4.7,34800,35
Đáp Án Của Thời Gian,Sách,119000,71300,732,4.8,47700,40
Tài Chính Doanh Nghiệp - Corporate Finance,Sách,659000,620000,102,4.5,39000,6
Hai Số Phận (Bìa Cứng),Sách,175000,113000,1981,4.7,62000,35
Sức Mạnh Tiềm Thức (Tái Bản),Sách,108000,64800,672,4.8,43200,40
"Càng Kỷ Luật, Càng Tự Do",Sách,109000,68600,1037,4.8,40400,37
Sách Tăng tốc luyện đề dành cho kì thi đánh giá năng lực của Đại học Quốc gia Tp. Hồ Chí Minh,Sách,225000,180000,66,5,45000,20
Tuổi Trẻ Đáng Giá Bao Nhiêu (Tái Bản),Sách,80000,55900,1819,4.7,24100,30
Thần Số Học Ứng Dụng,Sách,129000,96750,253,4.8,32250,25
Đi Tìm Lẽ Sống ( Tái Bản ),Sách,78000,46800,677,4.7,31200,40
Lâu Đài Bay Của Pháp Sư Howl (Tái Bản 2020),Sách,106000,78300,533,4.8,27700,26
Bộ sách Làm Giàu Từ Chứng Khoán (How To Make Money In Stock) phiên bản mới + Hướng Dẫn Thực Hành CANSLIM Cho Người Mới Bắt Đầu,Sách,700000,700000,26,4.6,0,0
Cẩm Nang Cấu Trúc Tiếng Anh,Sách,98000,64000,1473,4.8,34000,35
Thanh Gươm Diệt Quỷ - Kimetsu No Yaiba - Tập 22: Vòng Xoay Vận Mệnh - Bản Đặc Biệt - Tặng Kèm Bộ Huy Hiệu + Phụ Lục Độc Quyền: Báo Cáo Đặc Biệt Của Đội Diệt Quỷ,Sách,120000,115800,138,5,4200,4
Khởi Nghiệp Bán Lẻ - Bí Quyết Thành Công Và Giàu Có Bằng Những Cửa Hàng Đông Khách - Công Thức Kinh Doanh Và Quản Lý Cửa Hàng Hiệu Quả,Sách,199000,119000,1531,4.8,80000,40
Nghệ Thuật Đánh Cắp Ý Tưởng (10 Bí Mật Không Ai Nói Với Bạn Về Sáng Tạo),Sách,99000,62200,70,4.7,36800,37
Cậu Ma Nhà Xí Hanako Tập 3,Sách,28000,26500,107,5,1500,5
Thanh Gươm Diệt Quỷ - Tập 22: Vòng Xoay Vận Mệnh,Sách,25000,22500,115,4.8,2500,10
Làm thuê hay Khởi nghiệp,Sách,169000,149000,18,4.7,20000,12
Dám Bị Ghét,Sách,96000,71900,1485,4.7,24100,25
Giải Mã Siêu Trí Nhớ ,Sách,139000,139000,1585,4.8,0,0
Tôi Quyết Định Sống Cho Chính Tôi (Tặng Kèm 1 Sổ To Do List 2020),Sách,88000,70000,13,4.2,18000,20
PENBOOK – Luyện đề thi tốt nghiệp THPT môn Vật lí,Sách,225000,180000,11,4.8,45000,20
Sức Mạnh Của Ngôn Từ (Tặng Kèm 1 Photocard Mintbooks Limited),Sách,96000,60600,2113,4.8,35400,37
Quên Một Người Là Chuyện Của Thời Gian,Sách,89000,63100,986,5,25900,29
Người Giàu Có Nhất Thành Babylon (Tái Bản 2020),Sách,98000,58800,646,5,39200,40
Sứ mệnh khởi nghiệp,Sách,399000,399000,77,5,0,0
Hậu Vận Rất Đắt Xin Đừng Lãng Phí,Sách,129000,79900,258,4.8,49100,38
Nghệ Thuật Tinh Tế Của Việc Đếch Quan Tâm,Sách,95000,50000,1006,4.7,45000,47
Nhóc Miko! Cô Bé Nhí Nhảnh 34,Sách,20000,20000,100,5,0,0
3 Giờ Làm Việc Hết Việc Một Ngày - Phong Cách Làm Việc Của Người Thành Công,Sách,75000,56250,0,0,18750,25
Combo Dạy Con Làm Giàu (Trọn Bộ 13 Tập) (Tái Bản),Sách,1209000,604500,356,5,604500,50
Nhà Lãnh Đạo Không Chức Danh,Sách,80000,48000,1235,4.8,32000,40
Tuyệt kỹ Giao dịch bằng đồ thị nến Nhật – Japanese Candlestick Charting Techniques,Sách,499000,499000,733,4.8,0,0
Tự Học 2000 Từ Vựng Tiếng Anh Theo Chủ Đề,Sách,65000,26000,1711,4.7,39000,60
Bến Xe (Tái Bản 2020),Sách,76000,51400,542,4.7,24600,32
Chủ Nghĩa Khắc Kỷ - Phong Cách Sống Bản Lĩnh Và Bình Thản,Sách,125000,78400,1300,4.7,46600,37
All In Love - Ngập Tràn Yêu Thương (Tái Bản 2020),Sách,119000,83200,669,4.8,35800,30
"5 NHÓM BÍ MẬT ĐIỀU KHIỂN NHANH NGƯỜI KHÁC QUA NGÔN NGỮ CƠ THỂ  (Thuật Thành Công Nhanh, Giao Tiếp, Phát Hiện Nói Đôi, Làm Chủ Số Phận)",Sách,260000,260000,2,5,0,0
Cơ Thể Tự Chữa Lành: Phục Hồi Tuyến Giáp,Sách,180000,128800,59,4.8,51200,28
Mega 2021 - Siêu Luyện Đề 9 + THPT Quốc Gia 2021 - Tiếng Anh,Sách,185000,134600,230,5,50400,27
Your Name ,Sách,75000,56250,1889,4.8,18750,25
Storytelling With Data - Kể Chuyện Thông Qua Dữ Liệu (Cuốn Cẩm Nang Hướng Dẫn Trực Quan Hóa Dữ Liệu),Sách,319000,270900,379,4.8,48100,15
Chuyện Con Mèo Dạy Hải Âu Bay (Tái Bản 2019),Sách,49000,35600,1310,4.8,13400,27
Giáo Trình Hán Ngữ 1 - Tập 1 - Quyển Thượng (Phiên Bản Mới),Sách,89000,44500,1014,4.8,44500,50
Cậu Ma Nhà Xí Hanako - Tập 1,Sách,28000,23300,135,5,4700,17
Search Inside Yourself - Tạo Ra Lợi Nhuận Vượt Qua Đại Dương Và Thay Đổi Thế Giới (Tái Bản) ,Sách,120000,73800,414,4.8,46200,39
999 Lá Thư Gửi Cho Chính Mình - Mong Bạn Trở Thành Phiên Bản Hạnh Phúc Nhất (Phần 2),Sách,99000,67300,1250,4.7,31700,32
Mindmap English Grammar - Ngữ Pháp Tiếng Anh Bằng Sơ Đồ Tư Duy,Sách,190000,76000,1003,4.7,114000,60
25 Chuyên Đề Ngữ Pháp Tiếng Anh Trọng Tâm – (Tập 1),Sách,110000,69800,1142,4.8,40200,37
Thuật Đọc Tâm,Sách,199000,169150,0,0,29850,15
"Combo 2 sách Hack Não 1500 + Hack Não Ngữ Pháp - Tặng App học phát âm và ngữ pháp, làm chủ từ vựng và nắm chắc ngữ pháp tiếng Anh chỉ sau 2 tháng",Sách,820000,610000,798,5,210000,26
Spy X Family Tập 3,Sách,25000,20700,293,5,4300,17
Từng Có Người Yêu Tôi Như Sinh Mệnh  (Tặng Kèm Bookmark),Sách,129000,83200,447,5,45800,36
Cà Phê Cùng Tony (Tái Bản 2017),Sách,90000,45000,1380,4.8,45000,50
Boxset Your Name - Phiên Bản Manga,Sách,120000,96000,1384,4.8,24000,20
Bí Mật Của Phan Thiên Ân,Sách,69000,69000,1094,4.8,0,0
Boxset Doraemon Tuyển Tập Những Người Thân Yêu (6 Tập),Sách,180000,139900,475,5,40100,22
Phía Sau Nghi Can X (Tái Bản 2019),Sách,109000,82700,1169,4.8,26300,24
Men Chase Women Choose - Chuyện Tình Yêu Bạn Biết Được Bao Nhiêu?,Sách,109000,78400,30,4.8,30600,28
"Thiên Tài Bên Trái, Kẻ Điên Bên Phải",Sách,145000,91200,1823,4.6,53800,37
Mega 2021 - Siêu Luyện Đề 9 + THPT Quốc Gia 2021 - Toán Học,Sách,185000,136600,243,4.8,48400,26
Việt Nam Sử Lược - Trần Trọng Kim (Bìa Cứng),Sách,390000,292500,516,4.8,97500,25
Tôi Tài Giỏi - Bạn Cũng Thế (Tái Bản 2020),Sách,125000,93600,278,5,31400,25
Sách Tài Chính Cá Nhân Cho Người Việt Nam - Tặng Khóa học Online về Tài chính,Sách,200000,200000,174,4.7,0,0
Tâm Lý Học Hành Vi (Tặng Kèm 1 Bookmark ),Sách,98000,93100,1,5,4900,5
Mãi Mãi Là Bao Xa (Tái Bản 2019),Sách,135000,102500,690,4.7,32500,24
Tôi Từng Nghĩ Mọi Thứ Sẽ Ổn Khi Trở Thành Người Lớn (Tặng Kèm 1 Bookmark),Sách,96000,66100,1389,4.7,29900,31
"Hack Não 1500 - sách tự học từ vựng theo chủ đề, đi kèm App dạy phát âm của người bản xứ và 4 buổi học Livestream mỗi tuần - tự tin đọc hiểu và giao tiếp tiếng Anh, luyện siêu trí nhớ sau 50 ngày",Sách,495000,425000,1234,4.8,70000,14
Chữ Xưa Còn Một Chút Này (Ngày Ngày Viết Chữ),Sách,119000,95200,33,5,23800,20
Combo 2 Tập: Dior Tiên Sinh,Sách,274000,232900,0,0,41100,15
Sách Ehon - Combo 4 cuốn Bạn là ai vậy - Dành cho trẻ từ 0 - 3 tuổi,Sách,156000,89900,141,4.8,66100,42
Combo Truyện Tranh Song Ngữ Việt - Anh Cho Bé (12 Tập),Sách,180000,123800,938,4.7,56200,31
Thế Giới Rộng Lớn Lòng Người Chật Hẹp (Tặng Kèm 1 Bookmark ),Sách,92000,59700,875,4.8,32300,35
Phương pháp VPA - Kỹ thuật nhận diện Dòng Tiền Thông Minh bằng Hành Động Giá kết hợp Khối Lượng Giao Dịch,Sách,357000,357000,310,4.8,0,0
Đứa Con Của Thời Tiết,Sách,85000,68000,761,5,17000,20
Spy X Family Tập 2,Sách,25000,19300,396,4.8,5700,23
Bố Già (Mario Puzo),Sách,110000,77000,0,0,33000,30
Điều Kỳ Diệu Của Tiệm Tạp Hóa NAMIYA (Tái Bản),Sách,105000,71600,1235,4.8,33400,32
Cơ Thể Tự Chữa Lành: Nước Ép Cần Tây,Sách,148000,109800,193,5,38200,26
Cậu Ma Nhà Xí Hanako Tập 2,Sách,28000,28000,73,5,0,0
Sách Muôn Kiếp Nhân Sinh Tặng Bookmark,Sách,168000,67200,1002,4.8,100800,60
"Trời Sinh Vụng Về, Hãy Bù Đắp Bằng Sự Kiên Trì",Sách,129000,88900,70,4.7,40100,31
English Grammar in Use Book w Ans,Sách,178000,172800,951,5,5200,3
Hoàng Tử Bé (Tái Bản 2019),Sách,75000,50800,990,4.8,24200,32
Combo Sherlock Holmes Toàn Tập (Trọn Bộ 3 Tập),Sách,300000,149000,1048,4.6,151000,50
Tôi Cần Mỹ Nhan Thịnh Thế Để Làm Gì?,Sách,169000,133400,90,5,35600,21
Không Gia Đình (Tái Bản),Sách,119000,59500,1301,4.7,59500,50
Cậu Ma Nhà Xí Hanako Tập 4,Sách,28000,28000,81,5,0,0
Sách Người trong muôn nghề: Ngành Kinh tế có gì?,Sách,169000,149500,52,4.6,19500,12
"Đam Mê Không Để Làm Cảnh, Đam Mê Là Để Ra Tiền",Sách,179000,159000,62,5,20000,11
Sói đội lốt Cừu - Kẻ hiếu chiến ngầm và các thủ thuật thao túng tâm lí,Sách,110000,87900,192,4.8,22100,20
Oan Gia Tương Phùng (Tặng Kèm Bookmark + Postcard),Sách,139000,93100,378,4.8,45900,33
Bá Tước Monte Cristo (Bìa Cứng),Sách,199000,79600,629,5,119400,60
Hackers Ielts: Writing,Sách,239000,154100,794,4.8,84900,36
Traffic Secrets - Bí Mật Traffic (Russell Brunson),Sách,268000,241200,2,5,26800,10
"Chúng Ta Rồi Sẽ Hạnh Phúc, Theo Những Cách Khác Nhau [Tặng Kèm: 01 Bookmark]",Sách,86000,77400,1,5,8600,10
Đừng Chạy Theo Số Đông -  Cuốn Sách Bạn Cần Đọc Trước Khi Quá Muộn,Sách,200000,121700,20,4.8,78300,39
"Tai nghe không dây blueetooth LANITH cao cấp 5.0 TWS F9 – Tai nghe Bluetooth kiểu dáng hiện đại, thời thượng - Hàng nhập khẩu – TA0002",Thiết Bị Số - Phụ Kiện Số,399000,139000,8,4.8,260000,65
Tai Nghe Bluetooth Apple AirPods Pro True Wireless - MWP22 - Hàng Chính Hãng VN/A,Thiết Bị Số - Phụ Kiện Số,8500000,5090000,1242,4.8,3410000,40
Adapter Sạc 1 Cổng Anker 18W / 20W PowerPort III Nano Tích Hợp PowerIQ 3.0 - Hàng Chính Hãng,Thiết Bị Số - Phụ Kiện Số,400000,400000,2052,5,0,0
Tai nghe bluetooth 5.0 TWS Air Pro - Định vị + Đổi tên thiết bị và Tháo tai nghe dừng nhạc,Thiết Bị Số - Phụ Kiện Số,1399000,378000,4,4.3,1021000,73
"Loa bluetooth speaker LANITH A2 dáng dài 2 loa cực đỉnh – Tặng kèm dây sạc 3 đầu - Kiểu dáng sang trọng hỗ trợ thẻ nhớ, đài FM - Hàng nhập khẩu – LWR000A2.CAP001",Thiết Bị Số - Phụ Kiện Số,400000,249000,9,5,151000,38
Tai nghe bluetooth không dây F9 True wireless Dock Sạc có Led Báo Pin Kép,Thiết Bị Số - Phụ Kiện Số,750000,129000,728,4.5,621000,83
"Tai nghe Bluetooth Inpods 12 - Cảm biến vân tay, chống nước,màu sắc đa dạng- 5 màu sắc lựa chọn",Thiết Bị Số - Phụ Kiện Số,300000,76900,38,4.7,223100,74
Tai Nghe Nhét Tai JBL C150SI - Hàng Chính Hãng,Thiết Bị Số - Phụ Kiện Số,399000,199900,1997,4.5,199100,50
"Máy trợ giảng không dây T20 UHF có bluetooth, âm thanh to rõ, chống rút rít bắt xa khoảng cách lên đến 40m,  tặng túi đựng máy + micro có dây cài áo- Hàng Chính Hãng",Thiết Bị Số - Phụ Kiện Số,1250000,780000,31,4.5,470000,38
Chuột Không Dây Logitech M330 Silent Plus- Hàng Chính Hãng,Thiết Bị Số - Phụ Kiện Số,399000,289000,1154,4.7,110000,28
Tai Nghe Bluetooth Nhét Tai Apple AirPods 2 True Wireless - Hàng Chính Hãng VN/A,Thiết Bị Số - Phụ Kiện Số,5490000,3490000,836,4.7,2000000,36
Chuột Không Dây Logitech M331 Silent - Hàng Chính Hãng,Thiết Bị Số - Phụ Kiện Số,399000,299000,501,4.8,100000,25
Bảng Vẽ Wacom Intuos S CTL-4100 - Hàng Chính Hãng,Thiết Bị Số - Phụ Kiện Số,2025000,2024000,131,4.8,1000,0
"Tai Nghe Bluetooth Không Dây Lanith 5.0 F9 - Tai Nghe Airpods Cao Cấp - Kiểu Dáng Độc Đáo, Nhỏ Gọn - Âm Thanh Mềm Mượt, Thoải Mái, Không Làm Nhức Tai - Hàng Nhập Khẩu - TAI000F9B",Thiết Bị Số - Phụ Kiện Số,399000,139000,159,3.9,260000,65
Tai nghe Inpod i12 TWS Bluetooth 5.0 cho iPhone và Android kèm Hộp sạc - Hàng nhập khẩu,Thiết Bị Số - Phụ Kiện Số,229000,76800,21,4.7,152200,66
"Tai nghe Bluetooth Lanith i12 TWS 5.0 không dây – Tai nghe không dây kiểu dáng hiện đại, thời thượng - Hàng nhập khẩu – TAI0001",Thiết Bị Số - Phụ Kiện Số,199000,78000,4,3.8,121000,61
"Giá Đỡ Điện Thoại, Máy Tính Bảng Hợp Kim Nhôm Có Thể Điều Chỉnh Chiều Cao Helios",Thiết Bị Số - Phụ Kiện Số,200000,97000,150,4.6,103000,52
"Tai Nghe Bluetooth Không Dây 5.0, AMOI F9, Cảm Ứng Vân Tay, Màn Led Báo Pin, Kháng Nước, Chống Ồn, Âm Thanh Cực Chất - Hàng Nhập Khẩu",Thiết Bị Số - Phụ Kiện Số,550000,130000,277,4.5,420000,76
Pin Sạc Dự Phòng Xiaomi Redmi 20000mAh PB200LMZ Tích Hợp Cổng USB Type - C In Hỗ Trợ Sạc Nhanh 18W - Hàng Chính Hãng,Thiết Bị Số - Phụ Kiện Số,450000,409000,2586,4.7,41000,9
Tai nghe nhét tai BYZ S Super Bass cho IPHONE/IPAD/SAMSUNG (trắng) - Hàng chính hãng,Thiết Bị Số - Phụ Kiện Số,120000,43900,328,4.7,76100,63
Bảng Vẽ Wacom Intuos Bluetooth S CTL-4100WL - Hàng Chính Hãng,Thiết Bị Số - Phụ Kiện Số,2550000,2550000,56,4.8,0,0
"[[ KÈM VIDEO ]] - Pin Sạc dự phòng 10000mAh Robot - Cho di động/điện thoại Apple/iOS (iPhone/iPad), Android -RT170 - Hàng Chính Hãng",Thiết Bị Số - Phụ Kiện Số,435000,149000,1149,4.6,286000,66
"Tai Nghe Bluetooth True Wireless AMOI F9 5.0 Cảm Ứng Vân Tay, Dock Sạc có Led Báo Pin Kép - Hàng Nhập Khẩu",Thiết Bị Số - Phụ Kiện Số,650000,129000,360,4.5,521000,80
Pin Sạc Dự Phòng Samsung EB-P1100 10000mAh Hỗ Trợ Sạc Nhanh QC 2.0 - Hàng Chính Hãng,Thiết Bị Số - Phụ Kiện Số,390000,279000,1670,4.5,111000,28
Chuột không dây Bluetooth PROLiNK PMB8502 (800/1200/1600dpi/6 button)- Hàng chính hãng,Thiết Bị Số - Phụ Kiện Số,459000,289000,6,3.8,170000,37
Đồng Hồ Thông Minh Apple Watch SE GPS Only Aluminum Case With Sport Band (Viền Nhôm & Dây Cao Su) - Hàng Chính Hãng VN/A,Thiết Bị Số - Phụ Kiện Số,8990000,7190000,488,5,1800000,20
Bàn Phím Bluetooth Logitech K380 - Hàng Chính Hãng,Thiết Bị Số - Phụ Kiện Số,750000,559000,1542,4.7,191000,25
Tai Nghe Nhét Tai Sony ExtraBass MDR-XB55AP - Hàng Chính Hãng,Thiết Bị Số - Phụ Kiện Số,890000,583200,68,4.7,306800,34
Tai nghe nhét tai kiểm âm TAKSTAR TS-2260 AVSTAR - hàng chính hãng,Thiết Bị Số - Phụ Kiện Số,837000,352000,14,5,485000,58
Tai Nghe Bluetooth Air.podes Cảm Ứng Công Nghệ Cao 5.0,Thiết Bị Số - Phụ Kiện Số,750000,378000,16,4.6,372000,50
Bộ Thu Phát Bluetooth TP-Link UB400 USB Nano Bluetooth 4.0 - Hàng Chính Hãng,Thiết Bị Số - Phụ Kiện Số,219000,120000,106,4.7,99000,45
Chuột Không Dây Logitech M590 Slient - Hàng Chính Hãng,Thiết Bị Số - Phụ Kiện Số,700000,590000,1247,4.5,110000,16
"Tai nghe Bluetooth Lanith 5.0 đổi tên, định vị, cảm biển siêu nhạy - Hàng nhập khẩu - TAI00005W",Thiết Bị Số - Phụ Kiện Số,300000,149000,10,4.5,151000,50
Chuột Không Dây Logitech B175 - Hàng Chính Hãng,Thiết Bị Số - Phụ Kiện Số,250000,169000,373,4.6,81000,32
Chuột Có Dây Logitech B100 - Hàng Chính Hãng,Thiết Bị Số - Phụ Kiện Số,90000,68000,156,4.7,22000,24
Thẻ Nhớ Micro SDHC SanDisk UHS-1 32GB Class 10  - Hàng Chính Hãng,Thiết Bị Số - Phụ Kiện Số,160000,113000,1030,4.7,47000,29
"Tai nghe Bluetooth Lanith S11 kèm pin sạc dự phòng dung lượng cao – Kết nối Bluetooth 5.0 – Tai nghe không dây nghe nhạc, chơi game hiện đại – Hàng nhập khẩu",Thiết Bị Số - Phụ Kiện Số,400000,249000,8,5,151000,38
"Loa Bluetooth Sanag X6 Plus Bản Mở Rộng, chống nước IPX5. Hỗ Trợ Kết Nối Bluetooth 5.0, Thẻ Nhớ, Nhiều Màu Sắc - Hàng chính hãng",Thiết Bị Số - Phụ Kiện Số,500000,229000,433,4.6,271000,54
Adapter Sạc 1 Cổng USB Type-C 20W Apple MHJE3ZA/A - Hàng Chính Hãng,Thiết Bị Số - Phụ Kiện Số,890000,442000,651,5,448000,50
Tai nghe Bluetooth Inpods 12 Thời trang,Thiết Bị Số - Phụ Kiện Số,260000,86000,164,4.2,174000,67
"Tai Nghe Bluetooth Mini I12 Tws V5.0 (Trắng) Nút Cảm Ứng, Có Pop-Up, Tương Thích Với Các Dòng Smartphone, Tích Hợp Mic Nói Chuyện Điện Thoại, Đi Kèm Dock Sạc Dự Phòng, Âm Bass Sống Động – Hàng Chính Hãng",Thiết Bị Số - Phụ Kiện Số,269000,79000,13,4.2,190000,71
Đồng Hồ Thông Minh Apple Watch Series 6 GPS Only Aluminum Case With Sport Band (Viền Nhôm & Dây Cao Su) - Hàng Chính Hãng VN/A,Thiết Bị Số - Phụ Kiện Số,11990000,9990000,376,5,2000000,17
Chuột Không Dây Logitech M221 - Hàng Chính Hãng,Thiết Bị Số - Phụ Kiện Số,319000,215000,1331,4.7,104000,33
"Dây sạc nhanh Hoco X14 cho Iphone, Ipad (Giao Màu Ngẫu Nhiên) - Hàng Chính Hãng",Thiết Bị Số - Phụ Kiện Số,100000,33200,330,4.5,66800,67
"Tai nghe không dây Lanith Air Pro 4 Bluetooth 5.0 đổi tên, định vị, cảm biến siêu nhạy - Tai nghe bluetooth - Hàng nhập khẩu - TAI0PRO4W",Thiết Bị Số - Phụ Kiện Số,300000,149000,22,4.5,151000,50
[Miễn phí 1 năm] Sim 4G Vinaphone VD149 Tặng 120GB/Tháng Và 200 Phút Gọi Ngoại Mạng (Hàng Chính Hãng) - Màu ngẫu nhiên,Thiết Bị Số - Phụ Kiện Số,1100000,654000,161,4.6,446000,41
"Bao Tay Chơi Game Cảm Ứng Chống Mồ Hôi SIDOTECH Siêu Mỏng Vải Sợi Carbon Siêu Bền Chống Giãn Xù, Cảm Ứng Nhạy Thuộc Dòng Găng Tay Chơi Game Bao Ngón Tay Cho PUBG Tốc Chiến Freefire Liên Quân mobile - Hàng Chính Hãng",Thiết Bị Số - Phụ Kiện Số,115000,53000,14,4.1,62000,54
Adapter Sạc 2 Cổng Anker PowerPort Mini 12W - A2620 - Hàng Chính Hãng,Thiết Bị Số - Phụ Kiện Số,225000,225000,1230,4.7,0,0
"Chuột không dây Bluetooth PROLiNK PMB8001 GRY (1600dpi/3 button) tính năng nhấp chuột im lặng, thiết kế vỏ nhôm nhỏ gọn, tiện lợi khi sử dụng - Hàng chính hãng",Thiết Bị Số - Phụ Kiện Số,600000,299000,15,4.5,301000,50
Thẻ Nhớ Micro SD Samsung Evo Plus U1 32GB Class 10 - 95MB/s (Kèm Adapter) - Hàng Chính Hãng,Thiết Bị Số - Phụ Kiện Số,170000,114000,1809,4.7,56000,33
"Tai nghe Bluetooth Lanith i12 TWS 5.0 không dây tặng bao đựng silicone bảo vệ – Tai nghe không dây bluetooth kiểu dáng hiện đại, thời thượng - Tai nghe bluetooth nhét tai - Hàng nhập khẩu – TAI00I12W+OPTAIS55B",Thiết Bị Số - Phụ Kiện Số,200000,99000,48,4.5,101000,51
Đồng Hồ Thông Minh Apple Watch Series 3 GPS Aluminum Case With Sport Band - Hàng Chính Hãng VN/A,Thiết Bị Số - Phụ Kiện Số,7990000,4890000,198,4.7,3100000,39
Tai nghe TWS Bluetooth Không Dây  5.0 F9 Mini kèm Hộp sạc kiêm Sạc dự phòng ,Thiết Bị Số - Phụ Kiện Số,400000,139000,0,0,261000,65
Chuột Gaming Logitech G102 Gen 2 Lightsync - Hàng Chính Hãng,Thiết Bị Số - Phụ Kiện Số,690000,365000,93,4.7,325000,47
Thẻ Nhớ Micro SDXC SanDisk UHS-1 64GB Class 10  - Hàng Chính Hãng,Thiết Bị Số - Phụ Kiện Số,759000,175000,705,4.7,584000,77
Tai Nghe Nhét Tai Sony MDR-EX155AP - Hàng Chính Hãng,Thiết Bị Số - Phụ Kiện Số,690000,283000,935,4.6,407000,59
"Loa bluetooth Lanith Booms Bass L17, Có Quai Xách – Tặng dây cáp sạc 3 đầu - Hỗ trợ thẻ nhớ, Bluetooth,audio 3.5mm – LB000017.CAP0001 - Hàng chính hãng",Thiết Bị Số - Phụ Kiện Số,470000,289000,7,5,181000,39
"Tai Nghe Bluetooth Apple AirPods 2 True Wireless (Sạc Có Dây) - Model A2032,A2031,A1602 - Hàng Nhập Khẩu",Thiết Bị Số - Phụ Kiện Số,4590000,3190000,120,4.5,1400000,31
Tai nghe Bluetooth LG HBS-510 - Hàng Chính Hãng,Thiết Bị Số - Phụ Kiện Số,899000,355000,892,4.6,544000,61
"Dây cáp sạc đa năng Baseus Rapid 4 in 1 Type-C, 2 Lighning,  Micro USB, cho iPhone/ iPad, Smartphone & Tablet Android (3.5A, 1.2M, Fast charge 4 in 1 Cable) - Hàng chính hãng",Thiết Bị Số - Phụ Kiện Số,300000,93000,1648,4.6,207000,69
"Máy trợ giảng Hàn Quốc Sumin SM18 có dây dùng cho giáo viên pin siêu bền, chống rè, chống nhiễu- Hàng Chính Hãng",Thiết Bị Số - Phụ Kiện Số,980000,800000,1,5,180000,18
Loa Bluetooth 5.0 Kiêm Đồng Hồ Báo Thức - [[ 2 Trong 1 ]] - Robot - Hàng Chính Hãng,Thiết Bị Số - Phụ Kiện Số,350000,169000,1233,4.6,181000,52
Tai nghe cho iPhone 7 Plus/ 8 Plus/ X/ XSmax,Thiết Bị Số - Phụ Kiện Số,630000,63000,200,3.7,567000,90
"Máy trợ giảng không dây T20 UHF có bluetooth, âm thanh to rõ, chống rút rít bắt xa khoảng cách lên đến 40m,  tặng túi đựng máy + micro có dây cài áo- Hàng Chính Hãng",Thiết Bị Số - Phụ Kiện Số,1250000,780000,31,4.5,470000,38
Sim 4G MAY V77 (Vinaphone-Itelecom) gói cước 90GB/ tháng tốc độ cao – Hàng chính hãng - Giao màu ngẫu nhiên,Thiết Bị Số - Phụ Kiện Số,100000,30000,23,4.5,70000,70
Tai Nghe True Wireless Không Dây QCY T1C - Hàng Chính Hãng,Thiết Bị Số - Phụ Kiện Số,590000,205000,970,4.5,385000,65
"SIM 4G MOBIFONE TRÙM DATA FV99-FV119 (KHÔNG GIỚI HẠN DUNG LƯỢNG, Tốc Độ Luôn Luôn Cao 2Mbs)-Giao số ngẫu nhiên",Thiết Bị Số - Phụ Kiện Số,500000,90000,98,4.7,410000,82
Củ sạc nhanh 3 cổng Prolink PTC32501 Quick charge 3.0 - Hàng chính hãng,Thiết Bị Số - Phụ Kiện Số,399000,329000,2,4.5,70000,18
"Bộ Găng Tay Cảm Ứng Chơi Game Điện Thoại Chống Mồ Hôi, Chống Trượt Gear Chuyên Game Mobile-4017- Hàng Nhập Khẩu",Thiết Bị Số - Phụ Kiện Số,150000,9999,135,4.2,140001,93
Loa bluetooth JBL Flip 5 - Hàng chính hãng,Thiết Bị Số - Phụ Kiện Số,3500000,1798000,521,4.8,1702000,49
"Dây cáp sạc nhanh 2.4A Lightning dài 200cm hiệu Baseus Vertical cho iPhone / iPad trang bị đèn LED, sạc nhanh 2.4A, Công nghệ chống đứt SR - Hàng nhập khẩu",Thiết Bị Số - Phụ Kiện Số,250000,101000,16,4.1,149000,60
"Loa bluetooth Lanith Booms Bass L17, Có Quai Xách – Tặng dây cáp sạc 3 đầu - Hỗ trợ thẻ nhớ, Bluetooth,audio 3.5mm – LB000017.CAP0001 - Hàng chính hãng",Thiết Bị Số - Phụ Kiện Số,470000,289000,7,5,181000,39
Tai Nghe Nhét Tai Mi Basic Xiaomi HSEJ03JY - Hàng Chính Hãng,Thiết Bị Số - Phụ Kiện Số,150000,129000,41,4.6,21000,14
Loa Bluetooth JBL Go 2 - Hàng Chính Hãng,Thiết Bị Số - Phụ Kiện Số,850000,518800,643,4.7,331200,39
Tai Nghe Bluetooth Chụp Tai Sony WH-1000XM4 Hi-Res Noise Canceling - Hàng Chính Hãng,Thiết Bị Số - Phụ Kiện Số,8490000,6100100,368,5,2389900,28
"Miếng Phủ Bàn Phím Laptop 12-13/13-14/15-17 inch Silicon Chống Nước, Chống Bụi Bẩn Hàng Chính Hãng Helios",Thiết Bị Số - Phụ Kiện Số,149000,68000,45,4.5,81000,54
"Tai nghe có dây nhét tai Q21 âm thanh toàn cảnh 360 độ chân thực, sử dụng được với tất cả các dòng điện thoại có chân cắm tai nghe tròn 3.5",Thiết Bị Số - Phụ Kiện Số,65000,30000,15,4.7,35000,54
"Tai nghe bluetooth Lanith F9 Pro 5.0 - Tai nghe nhét tai kết nối không dây phiên bản quốc tế - Âm bass êm và sâu, chip AIC chống gây chói tai - Thiết kế thời thượng, hiện đại - Hàng nhập khẩu - TAI0F9PRO",Thiết Bị Số - Phụ Kiện Số,300000,146000,2,5,154000,51
Bàn Phím Có Dây Dell KB216 - Đen - Hàng Chính Hãng,Thiết Bị Số - Phụ Kiện Số,287500,149000,6,5,138500,48
"[Hàng nhập khẩu] Bộ vệ sinh Laptop, Macbook Cao Cấp JRC 5 Trong 1",Thiết Bị Số - Phụ Kiện Số,190000,149000,2,5,41000,22
Tai Nghe True Wireless Sony WF-1000XM3 Chống Ồn Chủ Động - Hàng Chính Hãng,Thiết Bị Số - Phụ Kiện Số,5490000,3701100,399,4.6,1788900,33
"Tai Nghe Bluetooth không dây i12 - TWS, Nhỏ Gọn, Tiện Lợi, Cảm ứng tay -Hàng Chính Hãng",Thiết Bị Số - Phụ Kiện Số,580000,93000,49,4.5,487000,84
Pin Sạc Dự Phòng Anker PowerCore 10400mAh - A1214 - Hàng Chính Hãng,Thiết Bị Số - Phụ Kiện Số,790000,619900,890,4.5,170100,22
Bảng Vẽ Màn Hình XP-Pen Artist 13.3 Pro fullHD 91%Adobe RGB Lực Nhấn 8192 Cảm Ứng Nghiêng (Kèm Găng Tay Họa Sĩ Và Đế Nghiêng) - Hàng Chính Hãng,Thiết Bị Số - Phụ Kiện Số,11075000,9930000,6,4.3,1145000,10
Tai Nghe Dùng Cho iPhone 5s / 6 / 6 Plus / 6s / 6s Plus Apple Loại 1,Thiết Bị Số - Phụ Kiện Số,100000,29500,25,4.2,70500,71
"Giá đỡ có chân đế, kẹp điện thoại để bàn đa năng tiện dụng xoay 270 độ, livestream, giải trí",Thiết Bị Số - Phụ Kiện Số,140000,30300,27,4.3,109700,78
"Găng tay chơi game chống mồ hôi hỗ trợ chơi game PUBG, Liên quân, Rules Of Survival Aturos M12 - Hàng chính hãng",Thiết Bị Số - Phụ Kiện Số,69000,12000,112,4.6,57000,83
Tai nghe Bluetooth nhét tai Lanith INPODS PRO TAI0006 – Tai nghe không dây phím bấm cảm ứng – Hàng nhập khẩu - Hoạt động liên tục tới 3h,Thiết Bị Số - Phụ Kiện Số,300000,119000,7,5,181000,60
"Lót Chuột, Pad Chuột Bền Đẹp 80x30 cm - Hàng Chính Hãng",Thiết Bị Số - Phụ Kiện Số,140000,39000,573,4.7,101000,72
Giá đỡ điện thoại để bàn gấp Điện thoại di động Giá đỡ bàn cho iPhone ipad pro mini Samsung Xiaomi Tablet Đứng tăng và giảm Giá đỡ có thể điều chỉnh,Thiết Bị Số - Phụ Kiện Số,150000,48000,48,4.2,102000,68
Dây cáp sạc Lightning cho iPhone iPad 1m - Hàng nhập khẩu,Thiết Bị Số - Phụ Kiện Số,120000,25500,54,4.5,94500,79
Tai Nghe Bluetooth Không Dây Lanith Apro 3 TWS – Tai Nghe Nhét Tai Không Dây – Bass Ấm – Sử Dụng Liên Tục Tới 4h - TAIAPPRO3,Thiết Bị Số - Phụ Kiện Số,400000,189000,12,4.8,211000,53
Cáp Sạc Lightning Dây Dù Hoco X14 2m Cho iPhone Siêu Bền - Hàng Chính Hãng,Thiết Bị Số - Phụ Kiện Số,90000,39500,79,5,50500,56
 Bảng Vẽ Điện Tử Gaomon 1060Pro - 10x6 inch,Thiết Bị Số - Phụ Kiện Số,1200000,429000,522,4.5,771000,64
Loa Bluetooth Sony SRS-XB12 - Hàng chính hãng,Thiết Bị Số - Phụ Kiện Số,1290000,960000,146,4.7,330000,26
Tai nghe bluetooth 5.0 TWS Air Pro - Định vị + Đổi tên thiết bị và Tháo tai nghe dừng nhạc,Thiết Bị Số - Phụ Kiện Số,1399000,299000,25,4.6,1100000,79
Loa Bluetooth JBL Charge 4 30W - Hàng Chính Hãng,Thiết Bị Số - Phụ Kiện Số,3990000,2489900,660,4.7,1500100,38
Thẻ Nhớ Micro SD Samsung Evo Plus 64GB Class 10 - 100MB/s (Kèm Adapter) - Hàng Chính Hãng,Thiết Bị Số - Phụ Kiện Số,350000,180000,965,4.6,170000,49
Tai nghe bluetooth nhét tai không dây tai phone bluetooth nghe nhạc X8,Thiết Bị Số - Phụ Kiện Số,599000,97000,152,4.5,502000,84
Bao Da Case Cover Dành Cho iPad Mini 5/ iPad Pro 11 inch/ iPad Air 3 / iPad Pro 3/ iPad Air 4 / iPad 7/8 / iPad Pro 12.9 inch - Hàng Chính Hãng Có Khe Cắm Apple Pencil,Thiết Bị Số - Phụ Kiện Số,300000,243000,13,5,57000,19
"Tai nghe không dây Lanith Air Pro 4 Bluetooth 5.0 đổi tên, định vị, cảm biến siêu nhạy - Tai nghe bluetooth - Hàng nhập khẩu - TAI0PRO4W",Thiết Bị Số - Phụ Kiện Số,300000,146000,5,4.6,154000,51
"Ốp lưng silicone case Dada chống sốc chống bám bẩn cho iPhone 6, 6S, 6Plus, 6SPlus, 7, 7Plus, 8, 8Plus, X, XS, XR, XSMax, 11, 11Pro, 11 Promax, SE2020 - Hàng chính hãng",Thiết Bị Số - Phụ Kiện Số,150000,48000,490,4.6,102000,68
Loa Bluetooth Mini Speaker B2,Thiết Bị Số - Phụ Kiện Số,78000,38500,38,3.8,39500,51
Pin điện thoại Pisen dành cho IPhone 7Plus+ Dung Lượng Cao - Chính Hãng(Hình Ảnh Bao Bì Thay Đổi Theo Đợt),Thiết Bị Số - Phụ Kiện Số,800000,439000,3,4.3,361000,45
Bộ Bàn Phím Giả Cơ và Chuột Chuyên Game G21 Led 7 Màu,Thiết Bị Số - Phụ Kiện Số,250000,126000,31,4.1,124000,50
"Tai Nghe True Wireless AUKEY EP-T25 Điều Khiển Cảm Ứng, Bluetooth 5.0, Chống Nước IPX5, Pin Lên Đến 25h - Hàng Chính Hãng",Thiết Bị Số - Phụ Kiện Số,990000,590000,270,4.1,400000,40
Chuột Máy Tính Có Dây Logitech B100 Black Chân USB - Hàng Chính Hãng,Thiết Bị Số - Phụ Kiện Số,150000,78000,130,4.7,72000,48
Cáp sạc đặc biệt Baseus Special Data Cable for Backseat (USB to iP+Dual USB) - Hàng Chính Hãng,Thiết Bị Số - Phụ Kiện Số,360000,189000,0,0,171000,48
Loa Bluetooth di động LG XBOOM Go PN1 - Hàng chính hãng,Thiết Bị Số - Phụ Kiện Số,690000,349000,71,5,341000,49
"SIM 4G VIETTEL V120Z - ĐĂNG KÝ ĐÚNG CHỦ ( 90.000/tháng: Có 4Gb/ngày, Gọi nội mạng miễn phí tất cả cuộc gọi dưới 20 phút, ngoại mạng 50 phút miễn phí). Chỉ áp dụng tại TPHCM và Cần Thơ",Thiết Bị Số - Phụ Kiện Số,150000,92000,39,4.5,58000,39
SIM 4G Viettel D500 Trọn Gói 4G 1 Năm Không Cần Nạp Tiền - Chính Hãng - Mẫu ngẫu nhiên,Thiết Bị Số - Phụ Kiện Số,500000,380000,6,3.8,120000,24
"Combo Case ốp kèm phủ phím cho Macbook đủ dòng - Bảo vệ chống va chạm, trầy xước tốt cho Macbook",Thiết Bị Số - Phụ Kiện Số,340000,299000,0,0,41000,12
 Dây Cáp Chuyển Đổi Lightning Sang jack tai nghe 3.5mm cho iPhone iPad tương thích mọi hệ điều hành IOS - Hàng nhập khẩu,Thiết Bị Số - Phụ Kiện Số,350000,49200,44,4,300800,86
"Tai Nghe Bluetooth True Wireless AMOI F9 5.0 Cảm Ứng Vân Tay, Nâng Cấp Dock Sạc có Led Báo Pin Kép - Hàng Nhập Khẩu",Thiết Bị Số - Phụ Kiện Số,899000,138000,508,4.5,761000,85
Cáp chuyển USB Type-c ra 4 cổng HDMI/ VGA/ USB và cổng sạc hỗ trợ chế độ Dex - UHV41160,Thiết Bị Số - Phụ Kiện Số,400000,297000,5,2,103000,26
Giá đỡ laptop nhôm có thể gấp gọn dành cho Macbook Ipad Surface và máy tính xách tay,Thiết Bị Số - Phụ Kiện Số,300000,141000,4,4,159000,53
Bộ Bàn Phím Giả Cơ và Chuột Chuyên Game G21 Led 7 Màu - Màu trắng,Thiết Bị Số - Phụ Kiện Số,300000,147000,107,4.5,153000,51
Tai nghe không dây Sony WH-CH510 - Hàng chính hãng,Thiết Bị Số - Phụ Kiện Số,1190000,875000,166,4.7,315000,26
Tai Nghe True Wireless Earbuds SOUNDPEATS TrueCapsule Smart Touch Bluetooth V5.0 - Hàng Chính Hãng,Thiết Bị Số - Phụ Kiện Số,1200000,488000,626,4.5,712000,59
"Pin Sạc Dự Phòng 10.000mAh ROBOT RT180 - 2 Cổng Sạc Vào Type-C/Micro, Kích Thước Mỏng và Nhẹ - HÀNG CHÍNH HÃNG",Thiết Bị Số - Phụ Kiện Số,360000,129000,174,4.6,231000,64
SIM 4G Vinaphone D500 Trọn Gói 1 Năm Tặng 5GB/Tháng - Hàng Chính Hãng- Mẫu Ngẫu Nhiên,Thiết Bị Số - Phụ Kiện Số,350000,264000,188,4.3,86000,25
Dây Đeo Thay Thế Cho Vòng Đeo Tay Thông Minh Xiaomi Mi Band 3 / Mi Band 4 Dẻo TPU,Thiết Bị Số - Phụ Kiện Số,60000,12300,71,4.7,47700,80
Pin Sạc Dự Phòng Anker PowerCore Select 10000mAh - A1223 - Hàng Chính Hãng,Thiết Bị Số - Phụ Kiện Số,600000,427400,334,4.8,172600,29
Bao Da Case Cover Dành Cho iPad Mini 5/ iPad Pro 11 inch/ iPad Air 3 / iPad Pro 3/ iPad Air 4 / iPad 7/8 / iPad Pro 12.9 inch - Hàng Chính Hãng Có Khe Cắm Apple Pencil,Thiết Bị Số - Phụ Kiện Số,300000,243000,13,5,57000,19
CỐC SẠC NHANH 2 CỔNG CHỐNG CHÁY NỔ HOCO C73 - CỦ SẠC ĐA NĂNG 2.4A CHO IPHONE SAMSUNG OPPO XAOMI CHÍNH HÃNG,Thiết Bị Số - Phụ Kiện Số,150000,85000,45,4.7,65000,43
Đồng Hồ Thông Minh Theo Dõi Vận Động Theo Dõi Sức Khỏe Xiaomi Watch Lite - Hàng Chính Hãng,Thiết Bị Số - Phụ Kiện Số,1990000,990000,99,4.8,1000000,50
Dây Cáp Sạc Lightning Cho iPhone Anker PowerLine II 1.8m - A8433 - Hàng Chính Hãng,Thiết Bị Số - Phụ Kiện Số,380000,361000,510,4.7,19000,5
"Miếng lót chuột, Pad chuột 90x40 cm Siêu rộng - Hàng chính hãng",Thiết Bị Số - Phụ Kiện Số,180000,50000,224,4.7,130000,72
Vòng Tay Thông Minh Xiaomi Mi Band 5 Hàng Chính Hãng,Thiết Bị Số - Phụ Kiện Số,990000,729000,4,5,261000,26
Dây Cáp Sạc Anker PowerLine III USB-C to USB-C 2.0 0.9m / 1.8m - A8852 / A8853 - Hàng Chính Hãng,Thiết Bị Số - Phụ Kiện Số,250000,249900,384,4.7,100,0
"Cáp Sạc Dây Dù Hoco X14 Iphone Chính Hãng Chống Đứt, Chống Rối - Cáp Sạc Lighning (màu ngẫu nhiên) - Chính Hãng ",Thiết Bị Số - Phụ Kiện Số,150000,37500,164,4.6,112500,75
Kính Cường Lực Full Màn KingKong 10D Đủ Mã Dành Cho iPhone 7/8Plus/ X/Xs/11pro / XR/11/ Xs Max/11Promax - DT062,Thiết Bị Số - Phụ Kiện Số,65000,39200,0,0,25800,40
Miếng Lót Chuột Dễ Thương Chữ Nhật ( 20 x 26 cm ),Thiết Bị Số - Phụ Kiện Số,60000,30000,371,4.8,30000,50
Đồng Hồ Thông Minh AMA Watch S2 Kết nối Bluetooth Theo dõi Sức khỏe Vận động Màn hình cong tràn viền Hàng chính hãng,Thiết Bị Số - Phụ Kiện Số,2800000,1387001,89,4.1,1412999,50
Tai nghe gaming có mic G901 dùng được cho điện thoại và máy tính + Tặng đế xem phim cho điện thoại,Thiết Bị Số - Phụ Kiện Số,250000,139000,58,4.5,111000,44
Loa Bluetooth JBL Go 3 - Hàng Chính Hãng,Thiết Bị Số - Phụ Kiện Số,1290000,889900,107,4.8,400100,31
Tai Nghe Nhét Tai Sony Fontopia MDR-E9LP - Hàng Chính Hãng,Thiết Bị Số - Phụ Kiện Số,199000,112000,640,4.3,87000,44
Bút Cảm Ứng Điện Dung 2 Trong 1 Baseus Smartphone Tablet IPad - Màu Ngẫu Nhiên - Hàng chính hãng,Thiết Bị Số - Phụ Kiện Số,350000,118000,21,4.5,232000,66
"Tai nghe Bluetooth Lanith 5.0 đổi tên, định vị, cảm biển siêu nhạy - Hàng nhập khẩu - TAI00005W",Thiết Bị Số - Phụ Kiện Số,300000,286000,6,4.7,14000,5
"Loa Bluetooth GUTEK C3 MINI Nghe Nhạc Cầm Tay Không Dây, Vỏ Nhôm Nghe Nhạc Hay, Âm Thanh Chất Lượng, Hỗ Trợ Kết Nối Bluetooth 4.0, Thẻ Nhớ, Đài FM, Usb, Nhiều Màu Sắc - Hàng Chính Hãng",Thiết Bị Số - Phụ Kiện Số,280000,104000,15,4.1,176000,63
"Cáp sạc nhanh, truyền dữ liệu tốc độ cao Baseus Cafule Type C cho Samsung S8/S9/ Note8/ Note9/ Xiaomi/ Huawei/ Oppo/Nokia ( 3A, Sạc nhanh Quick charge 3.0, Siêu bền)- Hàng nhập khẩu",Thiết Bị Số - Phụ Kiện Số,110000,56200,5,4.6,53800,49
Tai nghe không dây Bluetooth Inpod 12 Simple - Màu ngẫu nhiên,Thiết Bị Số - Phụ Kiện Số,249000,76000,2,4.5,173000,69
Sim 4G Vinaphone VD89 60GB/THÁNG (2GB/ngày) trọn gói 1 năm không nạp tiền - Chính hãng - Màu ngẫu nhiên,Thiết Bị Số - Phụ Kiện Số,700000,524000,108,4.5,176000,25
Tai Nghe Bluetooth I7s Bản Nâng Cấp,Thiết Bị Số - Phụ Kiện Số,700000,89000,76,4,611000,87
Chuột Không Dây Logitech M238 Marvel Collection - Hàng Chính Hãng,Thiết Bị Số - Phụ Kiện Số,499000,250000,133,4.8,249000,50
"Loa Bluetooth 5.0 - [[ Nghe 24h - Phạm Vi 20m, 200m2 ]] - VIVAN VS20 - Hàng Chính Hãng",Thiết Bị Số - Phụ Kiện Số,990000,499000,349,4.6,491000,50
Bàn Phím Có Dây Logitech K120 - Hàng Chính Hãng,Thiết Bị Số - Phụ Kiện Số,209000,139000,72,4.7,70000,33
"Dây Cáp sạc Lightning tự ngắt thông minh Baseus C Shape Light cho iPhone iPad (2.4A, Sạc nhanh, Sợi Carbon Siêu Bền, LED, Intelligent power-off) - Hàng Chính Hãng",Thiết Bị Số - Phụ Kiện Số,300000,93000,27,4.5,207000,69
Tai Nghe Nhét Tai BYZ S389 - Hàng Chính Hãng,Thiết Bị Số - Phụ Kiện Số,89000,41900,275,4.3,47100,53
ĐỒNG HỒ THÔNG MINH SMART WATCH T500 SERI 5,Thiết Bị Số - Phụ Kiện Số,690000,369000,4,2.8,321000,47
Loa Bluetooth Harman Kardon Onyx Studio 5 50W - Hàng Chính Hãng,Thiết Bị Số - Phụ Kiện Số,6500000,3188400,192,4.8,3311600,51
Tai nghe Bluetooth Lanith Không Dây - Tai Nghe Không Dây Thiết Kế Thời Trang – Chống Ồn Cực Tốt - Hàng Nhập Khẩu - TAI00003W,Thiết Bị Số - Phụ Kiện Số,399000,248000,0,0,151000,38
"Tai Nghe Bluetooth Mini I12 Tws V5.0 (Trắng) Nút Cảm Ứng, Có Pop-Up, Tương Thích Với Các Dòng Smartphone, Tích Hợp Mic Nói Chuyện Điện Thoại, Đi Kèm Dock Sạc Dự Phòng, Âm Bass Sống Động – Hàng Chính Hãng",Thiết Bị Số - Phụ Kiện Số,269000,86000,19,4.3,183000,68
Chuột Không Dây DareU LM115G MultiColor - Hàng Chính Hãng,Thiết Bị Số - Phụ Kiện Số,330000,155000,919,4.5,175000,53
Giá đỡ kẹp điện thoại kim loại gắn gương chiếu hậu xe máy C2,Thiết Bị Số - Phụ Kiện Số,129000,55500,242,4.5,73500,57
Bút Cảm Ứng Apple Pencil 2 MU8F2ZP/A - Hàng Chính Hãng,Thiết Bị Số - Phụ Kiện Số,3990000,3374900,258,4.8,615100,15
Đế Tản Nhiệt Laptop 2 Fan Có Led - Quạt Tản Nhiệt Laptop Thay Đổi Độ Dốc (Màu Đen),Thiết Bị Số - Phụ Kiện Số,259000,116200,51,4.5,142800,55
Pin Sạc Dự Phòng Xiaomi Gen 3 Version 2019 Polymer 10000mAh Tích Hợp Cổng Type-C PLM13ZM - Hàng Chính Hãng,Thiết Bị Số - Phụ Kiện Số,450000,319000,8,4.6,131000,29
Tai Nghe Bluetooth True Wireless Samsung Galaxy Buds Live - Hàng Chính Hãng,Thiết Bị Số - Phụ Kiện Số,4490000,2350000,180,4.7,2140000,48
Cốc Củ sạc nhanh Baseus công suất 24W Công nghệ Sạc Nhanh Qualcomm QC 3.0 tự động điều chình dòng sạc - Hàng nhập khẩu,Thiết Bị Số - Phụ Kiện Số,370000,129000,110,4.7,241000,65
Đồng Hồ Thông Minh Theo Dõi Vận Động Theo Dõi Sức Khỏei Huami Amazfit Bip U / Bip U Pro - Hàng Chính Hãng,Thiết Bị Số - Phụ Kiện Số,1399000,1091000,116,4.7,308000,22
Bộ Găng tay chơi game cảm ứng bao ngón tay chống mồ hôi chống trượt,Thiết Bị Số - Phụ Kiện Số,49000,12400,37,4.8,36600,75
SIM 4G Mobifone MDT250A Trọn Gói 1 Năm Không Cần Nạp Tiền - Hàng chính hãng - Mẫu ngẫu nhiên,Thiết Bị Số - Phụ Kiện Số,250000,197000,80,4.3,53000,21
Loa Bluetooth xách tay D-B16,Thiết Bị Số - Phụ Kiện Số,199000,85500,121,4.3,113500,57
Chuột Không Dây Microsoft 1850 Receiver USB - Hàng Chính Hãng,Thiết Bị Số - Phụ Kiện Số,350000,242000,316,4.6,108000,31
Tai Nghe Chụp Tai Sony ExtraBass MDR-XB550AP - Hàng Chính Hãng,Thiết Bị Số - Phụ Kiện Số,1190000,851600,622,4.6,338400,28
"Bộ củ cáp sạc nhanh 18W dùng cho iPhone 11 / iPhone 11 Pro Max / iPhone 11 Pro / iPad (sạc nhanh PD 3.0, kèm cáp sạc Type-C to lightning) ",Thiết Bị Số - Phụ Kiện Số,399000,151799,54,4.3,247201,62
"Tai nghe Bluetooth tai mèo đáng yêu có mic đàm thoại cao cấp, tai nghe mèo có đèn phát sáng cute tai nghe tai mèo thời trang, headphone Bluetooth đáng yêu có thể sử dụng khi chơi các tựa game online",Thiết Bị Số - Phụ Kiện Số,950000,259996,4,4,690004,73
Cáp chuyển đổi HDMI sang VGA FULL HD 1080P dây chuyển đổi từ hdmi sang vga,Thiết Bị Số - Phụ Kiện Số,55000,44500,62,4.2,10500,19
"Pin Sạc Dự Phòng RAVPower 20000mAh Quick Charge 3.0 + PD 60W, In/Out Type-C, Sạc Được Macbook - RP-PB201 - Hàng Chính Hãng",Thiết Bị Số - Phụ Kiện Số,1490000,1090000,211,4.7,400000,27
Cáp chuyển đổi HDMI sang VGA (20cm),Thiết Bị Số - Phụ Kiện Số,230000,99000,0,0,131000,57
Tai Nghe Bluetooth True Wireless Haylou GT1 Pro ( Phiên Bản Nâng Cấp Haylou GT1) - Hàng Chính Hãng,Thiết Bị Số - Phụ Kiện Số,600000,350000,130,4.5,250000,42
"Nho khô GUfoods - Không đường, nguyên hạt, thuần tự nhiên",Thực phẩm,135000,75000,11,4.5,60000,44
Thùng Mì Hảo Hảo Hương Vị Tôm Chua Cay (30 Gói/ Thùng),Thực phẩm,200000,107000,152,4.8,93000,47
Cơm Cháy TeTeFood Hương Vị Miền Núi Tây Nguyên 500 gram,Thực phẩm,99000,37000,805,4.5,62000,63
Ngũ Cốc Sấy Khô Calbee nội địa Nhật Bản 800g,Thực phẩm,219100,166666,41,4.8,52434,24
Nam việt quất sấy DK HARVEST nhập khẩu Canada 200g,Thực phẩm,130000,109000,106,4.8,21000,16
1kg Khô gà lá chanh thượng hạng hiệu TETE,Thực phẩm,250000,108000,1067,4.5,142000,57
Cơm Cháy Lắc Khô Gà Lá Chanh TeTe 500 gram,Thực phẩm,150000,45000,1252,4.5,105000,70
Ngũ cốc hoa quả Calbee Furugura Nhật Bản gói 800g,Thực phẩm,245000,173000,120,4.6,72000,29
Nước mắm Lê Gia - Cho bé ăn dặm 60ml,Thực phẩm,29000,28000,29,4.5,1000,3
"Yến Mạch Quaker Oats Old Fashion 4,52kg (Dạng Hạt cán Mỏng)",Thực phẩm,235000,161000,314,4.7,74000,31
Yến Mạch Quaker Oats Quick - 1 Minute 4.52kg ( Dạng Hạt Cán Vỡ nk my  ),Thực phẩm,300000,161000,168,4.7,139000,46
Hạt Chia Seeds Tím Absotute Organic Úc túi 1kg,Thực phẩm,150000,79000,337,4.7,71000,47
Mật Hoa Dừa Nguyên Chất 250Gr  - Sokfarm,Thực phẩm,150000,126000,11,4.5,24000,16
Thùng 24 Gói Miến Gói Phú Hương Hương Vị Sườn Heo Acecook,Thực phẩm,242000,208000,18,4.7,34000,14
Gạo Thơm ST25 Túi 5Kg - Đạt Giải Gạo Ngon Nhất Thế Giới Năm 2019 tại Manila -  Đặc Sản Sóc Trăng,Thực phẩm,195000,195000,546,4.7,0,0
"Hạt Chia Hữu Cơ DK Harvest - Hạt chia Organic có độ tinh khiết cao nhất, Highest Purity - 300g, 500g, 1000g",Thực phẩm,105000,69000,642,4.7,36000,34
Hạt Hạnh Nhân Sống DK Harvest Dùng làm Sữa Hạt,Thực phẩm,440000,356000,128,4.8,84000,19
1kg Bột Baking Soda Đa Công Dụng Arm & Hammer TETE,Thực phẩm,150000,42000,317,4.6,108000,72
Bột Baking Soda Đa Công Dụng  Arm & Hammer (454G),Thực phẩm,51000,31000,455,4.6,20000,39
"Yến Mạch Cán Mỏng DK Harvest - Túi 250g, 500g, 1kg, 4.5kg",Thực phẩm,35000,26000,270,4.7,9000,26
Hạt lanh nâu hữu cơ - Davert,Thực phẩm,98000,82000,0,0,16000,16
Thùng Mì Gói Hảo Hảo Hương Vị Tôm Chua Cay (30 Gói/Thùng),Thực phẩm,121000,107000,58,4.8,14000,12
Thùng mì 3 miền tôm chua cay gói 65g,Thực phẩm,110000,100000,15,4.8,10000,9
1 Kí Khô gà lá chanh loại ngon ( Giòn ngon - Đậm vị ) thương hiệu Nàng Khô,Thực phẩm,250000,109000,286,4.6,141000,56
Nui Lasicilia gói 500gr – Lasicilia Penne Rigate,Thực phẩm,60000,49000,3,4.7,11000,18
Ngũ Cốc Calbee Nhật Bản,Thực phẩm,227500,166666,17,4.5,60834,27
Bột ngũ cốc Damtuh Hàn Quốc 900g hộp 50 gói-PP,Thực phẩm,310000,272000,351,4.7,38000,12
Yến Mạch Tươi Canada Nguyên Chất túi 1kg ( Nguyên Hạt ),Thực phẩm,75000,35000,90,4.7,40000,53
1Kg Hạnh Nhân Rang Bơ Nhập Khẩu Cao Cấp Thương Hiệu SK FOOD,Thực phẩm,350000,175000,30,4.5,175000,50
Ngũ cốc Calbee vị Trái cây gói đỏ 800gr (Trái cây & các loại Hạt),Thực phẩm,245000,168900,9,3.9,76100,31
Nước Yến Sào win'sNest Kids (6 Lọ x 70 ml / Lốc),Thực phẩm,269000,123000,493,4.6,146000,54
Táo Đỏ Tân Cương Dried Jujube DK Harvest,Thực phẩm,99000,75000,388,4.7,24000,24
"Nhân Óc Chó Đỏ DK HARVEST - Là loại hạt siêu dinh dưỡng, Có Omega 7,Giá trị dinh dưỡng cao gấp 3,3 lần so với loại óc chó thường",Thực phẩm,169000,139000,93,4.6,30000,18
"Hạt Hạnh Nhân Rang Mộc DK HARVEST Nhập Khẩu - Hàng loại 1 nguyên vị và không thêm phụ gia - 250g, 500g",Thực phẩm,119000,110000,340,4.7,9000,8
"Hạt Hạnh Nhân Sống DK Harvest  Nhập Khẩu - Túi 500g, 1000g",Thực phẩm,299000,185000,80,4.8,114000,38
COMBO SIÊU TIẾT KIỆM - 1 Hũ Hạt Hạnh Nhân DK Harvest 250g + 1 Hũ Hạt Óc Chó DK Harvest 200g,Thực phẩm,279000,185000,480,4.7,94000,34
"Hạt Dẻ Cười DK HARVEST Nhập Khẩu USA, Giàu chất chống oxy hóa - 250g, 450g",Thực phẩm,180000,170000,70,4.8,10000,6
Combo 2 gói Ngũ cốc hoa quả Calbee Furugura Nhật Bản (gói 800g x 2),Thực phẩm,441900,329000,4,5,112900,26
Kem Đặc Có Đường Dutch Lady Cô Gái Hà Lan Túi Thông Minh (560G),Thực phẩm,32000,32000,267,4.7,0,0
Hạt Bí Xanh DK Harvest (đã tách vỏ),Thực phẩm,99000,65000,707,4.7,34000,34
HẠT LANH NÂU NUNUTS HŨ 500G- HẠT SỐNG,Thực phẩm,170000,95000,1,5,75000,44
Nước Yến Sào win'sNest Nhân Sâm (6 Lọ x 70 ml / Hộp) thích hợp cho người lớn và người bệnh trong quá trình hồi phục sức khỏe ,Thực phẩm,279000,136000,452,4.6,143000,51
Câu Kỷ Tử DK Harvest (Nhập Khẩu USA),Thực phẩm,129000,84000,259,4.6,45000,35
Kem Sữa Đặc Ngôi Sao Phương Nam Vinamilk - Hộp Giấy 1284G Xanh Biển,Thực phẩm,55000,53000,36,5,2000,4
Trạng Gạo Nhất Vị Lúa Mùa- Gạo Đặc Sản- Giống Lúa Dài Ngày (Thơm- Dẻo- Đậm Đà- Dễ Nấu),Thực phẩm,160000,158000,8,4.6,2000,1
Combo 2 hộp baking soda đa công dụng nhập khẩu Mỹ,Thực phẩm,115000,89000,1,5,26000,23
Khô Gà Lá Chanh Cay TeTe 500gram,Thực phẩm,199000,68000,635,4.3,131000,66
Ngũ Cốc Trái Cây Calbee Ít Đường Nhật Bản 600g,Thực phẩm,305000,199000,20,4.5,106000,35
Gạo Ngọc Sen Lotus Rice 5kg - Cơm mềm dẻo ít - Chuẩn xuất khẩu,Thực phẩm,108900,99000,35,4.7,9900,9
Hạt Chia Seeds đen Úc túi 500G,Thực phẩm,130000,58000,26,4.7,72000,55
"Hạt Mix 8 loại hạt nhập khẩu DK HARVEST - Nhân hạt óc chó vàng, Nhân hạt óc chó đỏ, Hạnh nhân, Macca, Hạt điều, Hạt bí xanh tách vỏ, Hướng dương, Hạt dẻ cười.",Thực phẩm,320000,189000,399,4.5,131000,41
Thùng 24 Gói Miến Gói Phú Hương Hương Vị Thịt Bằm Acecook,Thực phẩm,242000,201600,0,0,40400,17
Gạo lứt ăn kiêng GUfoods (1kg) - Hỗ trợ Giảm cân - Thực dưỡng - Eat clean (có 2 lựa chọn: Lứt đỏ + Lứt tím than),Thực phẩm,95000,39900,25,4.8,55100,58
"Nhân Hạt Óc Chó DK Harvest - Nhập khẩu USA/Chile - 100g, 200g, 400g",Thực phẩm,145000,103000,372,4.5,42000,29
Nho Khô Mỹ Không Hạt Sunview Raisins 425g (Nho Thập Cẩm),Thực phẩm,180000,99000,243,4.7,81000,45
Thùng 6 hộp  Miến Chua Cay Trùng Khánh - chính hãng JUNJIE,Thực phẩm,140000,88000,191,4.1,52000,37
"Hạt óc chó còn vỏ ( đỏ) Mỹ, tặng kèm khạy tách vỏ trong túi, sản phẩm của Nunuts.",Thực phẩm,125000,90000,6,5,35000,28
1kg Khô gà lá chanh thượng hạng cao cấp,Thực phẩm,250000,117000,1029,4.5,133000,53
1Kg Khô Gà Lá Chanh Loại Ngon Thương Hiệu SK FOOD,Thực phẩm,250000,112000,97,4.5,138000,55
Mì Goreng Vị Đặc Biệt Indomie (85G X 40 Gói/Thùng),Thực phẩm,195000,189000,37,5,6000,3
MIX 5 HẠT DINH DƯỠNG NUNUTS  CÒN VỎ ( 1 HỘP 500G) MÃ HÀNG NN5,Thực phẩm,270000,150000,2,4.5,120000,44
HẠT MẮC CA ÚC ĐÃ TÁCH VỎ HŨ 500G ( NHÂN MACCA ÚC),Thực phẩm,450000,399000,67,4.7,51000,11
Ngũ cốc Calbee Furugura Carbohydrate 25% Off 600g - Nhập khẩu Nhật Bản,Thực phẩm,250000,169500,12,4.8,80500,32
Thùng Mì Ly Modern Hương Vị Lẩu Thái Tôm (24 Ly x 67g),Thực phẩm,166000,157000,25,5,9000,5
Hạt Hạnh Nhân Sống DK Harvest Dùng làm Sữa Hạt,Thực phẩm,440000,356000,128,4.8,84000,19
Thùng 24 Gói Snack Mì Nà Ní 2 hương vị (52g),Thực phẩm,135000,125000,16,4.6,10000,7
1Kg Cơm Cháy Lắc Khô Gà Giòn Ngon Hiệu SK FOOD,Thực phẩm,150000,85000,96,4.3,65000,43
Bộ 2 hộp Bột Baking Soda Đa Công Dụng 454g - Arm & Hammer,Thực phẩm,80000,49900,223,4.7,30100,38
Hạt Điều Rang Không Muối Lafooco 450g,Thực phẩm,200000,180000,0,0,20000,10
"Nước Yến Sào win'sNest Đường Phèn ( 6 Lọ * 70 ml / Hộp) giúp bồi bổ sức khỏe tăng cường sức đề kháng, thích hợp cho mọi đối tượng và trẻ em từ 1 tuổi trở lên",Thực phẩm,269000,133000,302,4.7,136000,51
Hạt Đậu Gà Chickpeas DK HARVEST nhập khẩu Nam Mỹ/ Ấn Độ 700g,Thực phẩm,130000,71000,319,4.7,59000,45
Lương Khô BB702 - Công Ty Cổ Phần 22 (700g),Thực phẩm,70000,70000,197,4.5,0,0
Nui nơ Farfalle Pasta La Sicilia gói 500gr ,Thực phẩm,60000,55000,1,5,5000,8
"Bún gạo lứt ăn kiêng GUfoods - Giảm cân, Thực dưỡng, Eat clean",Thực phẩm,35000,19900,35,4.8,15100,43
"TÁO ĐỎ HÀN QUỐC 1Kg, cao cấp, bổ dưỡng, tặng túi đựng hộp quà",Thực phẩm,210000,139000,25,4.5,71000,34
"Hạt Nêm Knorr Từ Thịt Thăn, Xương Ống Và Tủy Bổ Sung Vitamin A (900g) - 32010220",Thực phẩm,74000,61000,28,4.7,13000,18
Đậu gà hữu cơ 500g - Reformhaus,Thực phẩm,195000,99000,13,4.8,96000,49
Combo 2 Gói Yến mạch Hafer Flocken (500g x 2 gói) - Deutschland (Dạng hạt cán vỡ),Thực phẩm,182000,73000,58,4.8,109000,60
Mì 3 miền gold tôm chua cay đặc biệt 75g x 30 gói,Thực phẩm,140000,100000,36,5,40000,29
Thùng Mì Gói Hảo Hảo Tôm Xào Chua Ngọt (30 Gói/Thùng),Thực phẩm,125000,108000,23,5,17000,14
"Hạt Dẻ Cười DK HARVEST Nhập Khẩu USA, Giàu chất chống oxy hóa - 250g, 450g",Thực phẩm,180000,170000,70,4.8,10000,6
Chà Là Nguyên Cành DK Harvest Nhập khẩu Tunisia,Thực phẩm,199000,166000,180,4.7,33000,17
Gạo Hạt Ngọc Trời Thiên Long Túi 5Kg - Gạo thơm đặc sản,Thực phẩm,125000,99000,41,5,26000,21
Hạt điều rang muối nhân trắng bể nửa sviet 500g,Thực phẩm,136000,76000,216,4.5,60000,44
Nhân Hạt Óc Chó Sống DK Harvest Dùng làm Sữa 1000g,Thực phẩm,725000,369000,91,4.7,356000,49
"Hạt Macca Úc nứt vỏ Smile Nuts (215g - 500g) | 100% nhập khẩu từ Úc, giòn béo, thơm ngon",Thực phẩm,119000,80000,94,4.7,39000,33
Sữa đặc có đường Brothers 390gr,Thực phẩm,17000,17000,38,5,0,0
Gạo lứt đen hữu cơ cao cấp/ECOBA Huyền Mễ 1kg - Thơm ngon dẻo ngọt - Thanh lọc cơ thể,Thực phẩm,107100,99000,137,4.7,8100,8
Bột làm kem Vani (Vani Ice Cream Powder) La Sicilia (Ý) - 1.5 kg,Thực phẩm,610000,580000,1,5,30000,5
Yến mạch Quaker Oats nguyên chất 100% nhập khẩu từ Mỹ - Chính Hãng,Thực phẩm,289000,161000,61,4.8,128000,44
Lốc 5 Gói Mì Khô Gà Cay Samyang (140G / Gói),Thực phẩm,160000,140900,2,4.5,19100,12
Gạo lứt ăn kiêng GUfoods (1kg) - Hỗ trợ Giảm cân - Thực dưỡng - Eat clean (có 2 lựa chọn: Lứt đỏ + Lứt tím than),Thực phẩm,95000,33000,25,4.8,62000,65
"Nhân Hạt Óc Chó DK Harvest - Nhập khẩu USA/Chile - 100g, 200g, 400g",Thực phẩm,275000,199000,372,4.5,76000,28
Gạo lứt đỏ hữu cơ cao cấp - ECOBA Huyết Rồng 1kg - Cơm mềm dễ ăn - Gạo lứt ăn kiêng,Thực phẩm,107100,95000,119,4.5,12100,11
1Kg Nhân Hạt Bí Xanh Nhập Khẩu Cao Cấp Thương Hiệu SK FOOD ,Thực phẩm,250000,135000,29,4.7,115000,46
Túi 16 Gói Bột Ngũ Cốc Nestle Nesvita Ít Đường (25g),Thực phẩm,66000,64000,156,4.8,2000,3
HẠT MẮC CA ÚC ĐÃ TÁCH VỎ HŨ 500G ( NHÂN MACCA ÚC),Thực phẩm,450000,399000,67,4.7,51000,11
Thùng 24 Gói Miến Phú Hương Hương Vị Lẩu Thái Tôm Acecook,Thực phẩm,242000,208000,7,5,34000,14
500 gram Hạt Hạnh Nhân TETE - Đã Rang,Thực phẩm,199000,125000,79,4.6,74000,37
HẠT HẠNH NHÂN RANG MỘC NUNUTS (1 HŨ 500G ),Thực phẩm,250000,189000,49,4.7,61000,24
MIX 5 HẠT DINH DƯỠNG NUNUTS MÃ NN3 HŨ 500G,Thực phẩm,300000,250000,45,4.7,50000,17
"Gạo Lứt Đỏ Túi 1Kg - Gạo Ngọc Đỏ Ông Thọ - Gạo lứt tốt cho sức khỏe, ăn kiêng, tiều đường, giảm cân, cao huyết áp",Thực phẩm,58000,38000,87,4.6,20000,34
Combo Bánh gạo Hàn Quốc 500g kèm sốt nấu Tokbokki 150g,Thực phẩm,100000,80000,49,4.7,20000,20
Túi Hạt Chia Đen Hữu Cơ Mỹ REAL FOOD STORE (1kg),Thực phẩm,201000,119000,250,4.7,82000,41
Sốt nấm cục – Truffle Sauce La Sicilia (Italia) hũ 500g,Thực phẩm,520000,510000,0,0,10000,2
Bánh Gạo Tteokbokki Kèm Chả Cá Hàn Quốc Fish Cake Cực Ngon 4 vị (143g),Thực phẩm,55000,54444,14,4.1,556,1
BẮP HẠT NỔ POPCORN 400G,Thực phẩm,60000,29000,178,4.5,31000,52
"Nho Khô 3 Màu DK Harvest nhập khẩu Chile  - Thơm ngon, vị ngọt tự nhiên",Thực phẩm,69000,49000,270,4.6,20000,29
1KG HẠT ĐIỀU NGUYÊN RANG TỎI ỚT LOẠI CAO CẤP THƯƠNG HIỆU SK FOOD,Thực phẩm,150000,75000,47,3.9,75000,50
Sữa Đặc Chế Brothers Trung Nguyên - Dành cho Pha Cà Phê( Lon 390gam),Thực phẩm,25000,18000,1,1,7000,28
Kem Sữa Đặc Đặc Ngôi Sao Phương Nam Xanh Lá - Hộp Giấy 380G,Thực phẩm,18000,17000,72,4.8,1000,6
Thùng 10 Gói Miến Phú Hương Yến Tiệc,Thực phẩm,329000,281000,6,5,48000,15
(1KG) Hạt Điều Rang Muối Sạch Vỏ Chất Lượng Hiệu SK FOOD,Thực phẩm,250000,129000,21,4,121000,48
Cơm cháy khô gà loại 1 ( Giòn ngon - đậm vị ) thương hiệu Nàng Khô - 1 Kí ( 2 Hũ 530 gram ),Thực phẩm,300000,95000,112,4.8,205000,68
HẠT HẠNH NHÂN NGUYÊN VỊ 500G - ĐÃ RANG,Thực phẩm,320000,140000,340,4.6,180000,56
"500G MIX 3 HẠT DINH DƯỠNG ĐÃ TÁCH VỎ (MACCA, ÓC CHÓ, HẠNH NHÂN) ĂN LIỀN",Thực phẩm,350000,185000,72,4.7,165000,47
Túi Hạt Bắp Nổ BARN làm bỏng ngô REAL FOOD STORE ( Nhiều lựa chọn),Thực phẩm,46000,38000,45,4.5,8000,17
Hạt lanh nâu DK HARVEST (nhập khẩu Canada) - 500g,Thực phẩm,200000,75000,142,4.7,125000,63
Lương Khô Bay - Công Ty Cổ Phần 22 (1000g),Thực phẩm,105000,105000,193,4.5,0,0
Lá Rong Biển Khô Daesang 200g Dùng Nấu Canh Rong Biển - Nhập Khẩu Hàn Quốc,Thực phẩm,207100,135000,32,4.8,72100,35
Nước Yến Sào win'sNest Kids (70ml),Thực phẩm,45000,20000,78,4.7,25000,56
Ngũ cốc hoa quả Calbee Furugura Nhật Bản - Nhập khẩu chính hãng,Thực phẩm,350000,167900,9,4.3,182100,52
Hạt Điểu Rang Tỏi Ớt Giòn Ngon Hiệu SK FOOD - Hũ 250G,Thực phẩm,59000,29000,16,4.8,30000,51
"Gạo Lứt Tím Than Túi 1Kg - Gạo Ông Thọ - Thơm mềm dẻo, tốt cho sức khỏe",Thực phẩm,58000,38000,99,4.6,20000,34
Túi Yến Mạch Canada 100G - Thương hiệu Real Food Store,Thực phẩm,15000,7000,48,4.8,8000,53
Hạt Đậu Gà Chickpeas DK HARVEST nhập khẩu Nam Mỹ/ Ấn Độ 700g,Thực phẩm,130000,71000,319,4.7,59000,45
Gạo Quê Dẻo Vừa Đỗ Quyên (5kg),Thực phẩm,90000,89000,96,4.5,1000,1
Thùng 40 Gói Mì Xào Khô Indomie goreng - mix vị,Thực phẩm,210000,192000,89,4.3,18000,9
"Hạt Nêm Knorr Từ Thịt Thăn, Xương Ống Và Tủy Bổ Sung Vitamin A (1200g) - 32010222",Thực phẩm,94000,78000,194,4.8,16000,17
"500gr MIx 8 Loại Hạt (hạnh nhân, óc chó vàng, óc chó đỏ, nho khô đen, nho khô vàng, macca, nam việt quất, bí xanh)",Thực phẩm,300000,150000,125,4.3,150000,50
1KG HẠT ĐIỀU VỎ LỤA RANG MUỐI XẾP HOA CAO CẤP THƯƠNG HIỆU SK FOOD,Thực phẩm,350000,175000,63,4.6,175000,50
Thùng Mì Gói Đệ Nhất Hương Vị Thịt Bằm,Thực phẩm,201000,175000,16,4.8,26000,13
Gạo lứt nâu hữu cơ cao cấp/ECOBA Kim Mễ 1kg - Gạo lứt giảm cân - Cơm ngon mềm dẻo,Thực phẩm,100800,90000,46,4.7,10800,11
1Kg Cơm Cháy Lắc Khô Gà Giòn Ngon Chất Lượng,Thực phẩm,150000,85000,149,4.6,65000,43
Yến Mạch Ăn Kiêng TETE 500 gram,Thực phẩm,159000,47000,122,4.6,112000,70
Túi Hạt Chia Tím Organic Úc (1kg),Thực phẩm,398000,223000,47,4.6,175000,44
Khô heo cháy tỏi đặc biệt ( Thơm ngon - đậm vị ) thương hiệu Nàng Khô - 500 Gram,Thực phẩm,150000,80000,68,4.2,70000,47
Ngũ Cốc Trái Cây Calbee Nhật Bản 700g,Thực phẩm,299000,212000,81,4.7,87000,29
500gr táo đỏ khô cao cấp,Thực phẩm,165000,69000,145,4.3,96000,58
(1KG) Hạt Điều Rang Muối Sạch Vỏ Chất Lượng Hiệu SK FOOD,Thực phẩm,250000,129000,21,4,121000,48
Cơm cháy mắm ớt mỡ hành giòn ngon - Bịch 3 Miếng,Thực phẩm,45500,25000,11,3.8,20500,45
Vải Sấy Khô Vinafruits (500g),Thực phẩm,100000,49999,368,4.5,50001,50
Thùng Mì 30 Gói Hảo 100 Hương Vị Tôm Chua Cay ,Thực phẩm,99000,87000,16,4.8,12000,12
Hạt Mix 3 Loại hạt nhập khẩu (Óc chó - Hạt Macca - Hạnh Nhân) DK Harvest,Thực phẩm,230000,179000,185,4.5,51000,22
"Nhân Hạt Điều Sống Nguyên Hạt Dùng Làm Sữa Hạt DK Harvest - Túi 500g, 1000g",Thực phẩm,299000,189000,60,4.8,110000,37
Rong Biển Sấy Chú Tiểu (50g),Thực phẩm,28000,24000,299,4.3,4000,14
Gạo sạch GUfoods (dẻo - mềm - thơm) (1kg),Thực phẩm,28000,19900,239,4.5,8100,29
"Nhân Hạt Bí Xanh Smile Nuts (265g - 500g) | Nhân bí xanh đã nướng nguyên vị, hàng nhập khẩu 100%",Thực phẩm,95000,64000,69,4.7,31000,33
Bột CaCao TeTe Giúp Giảm Cân 500gram,Thực phẩm,150000,47000,322,4.5,103000,69
Hạt Bí Xanh Đã Tách Võ (Đã Rang) TETE 500 gram,Thực phẩm,149000,76000,97,4.6,73000,49
Muối chấm Hảo hảo tôm chua cay 50 gói x 10g,Thực phẩm,95000,75000,6,4.7,20000,21
Lẩu tự sôi ( lẩu ăn liền ) - Lẩu bò tê cay - chính hãng 7 Leaves,Thực phẩm,110000,110000,78,3.6,0,0
1KG KHÔ GÀ BƠ TỎI ĐẶC BIỆT THƯƠNG HIỆU SK FOOD,Thực phẩm,250000,115000,43,4.6,135000,54
Heyday Bột Cacao Nguyên Chất Không Đường Việt Nam - Dòng Origin - Chứng Nhận UTZ - Hỗ Trợ Giảm Cân - Túi Giấy 250g,Thực phẩm,97000,97000,210,4.6,0,0
"Hạt Bí Xanh (Đã Tách Vỏ) Nhập Khẩu – DK Harvest - 100% nguyên chất và không ướp muối - 250g, 500g",Thực phẩm,99000,79000,168,4.7,20000,20
1 Hộp miến chua cay - chính hãng JUNJIE,Thực phẩm,22000,17000,21,4,5000,23
Thùng 40 Gói Mì Xào Khô Indomie Vị đặc biệt - Mi Goreng Fried Noodle (85g x 40),Thực phẩm,200000,189000,55,4.8,11000,6
Yến Mạch CANADA thùng 4.52kg ( nguyên hạt cán mỏng ),Thực phẩm,220000,145000,107,4.5,75000,34
Trân châu đường đen 300g (10*30g),Thực phẩm,27000,27000,10,4.7,0,0
Bánh Ăn Sáng Nestle KoKo Krunch (170g),Thực phẩm,52000,50000,72,4.7,2000,4
500GR Yến mạch tươi nguyên chất Hafer Flocken - Nhập Khẩu Từ Đức,Thực phẩm,100000,29000,23,4.8,71000,71
COMBO 2 HŨ KHÔ GÀ XÉ LÁ CHANH (GÀ CHÀ BÔNG CAY) TÂN LỘC PHÁT - MỖI HŨ 300G,Thực phẩm,150000,130000,60,4.6,20000,13
Nho Khô Nhập Khẩu Cao Cấp Thương Hiệu SK FOOD - 1Kg 2 Hũ,Thực phẩm,180000,89000,21,4.6,91000,51
Bột ngũ cốc dinh dưỡng Calsome hương Sô cô la,Thực phẩm,60000,49000,110,4.8,11000,18
"Gạo Nhật hữu cơ cao cấp/ECOBA Sakura 1kg - Nấu cháo cho bé ăn dặm - Hạt tròn, cơm mềm dẻo ngọt - 100% Organic",Thực phẩm,105600,95000,45,4.8,10600,10
Gạo Lứt Huyết Rồng Hoa Sen - Hoa Sen Red Rice - Cơm mềm dễ ăn - Chế độ ăn kiêng và thực dưỡng - Túi 2kg,Thực phẩm,149000,120000,54,4.7,29000,19
Hạt hướng dương Chacheer vị Dừa-130g/gói ( Lốc 5 gói ),Thực phẩm,150000,119000,61,4.7,31000,21
Gạo Lức Phú Minh Tâm (2kg),Thực phẩm,46000,44000,195,4.7,2000,4
Túi Hạt Chia Hữu Cơ Úc Absolute Organic (400g),Thực phẩm,325000,160000,58,4.7,165000,51
Bánh Gạo Tokpokki Hàn Quốc Vị Phô Mai Kèm Sốt Nấu O'Food (Gói 140g),Thực phẩm,50000,36000,21,4.5,14000,28
"Gạo lứt sấy ăn liền GUfoods  - Ăn kiêng, thực dưỡng, eat clean",Thực phẩm,33000,15900,35,4.7,17100,52
Hộp 6 Hũ Nước Yến Sào Sanest Có Đường (70ml / hũ),Thực phẩm,250000,225000,67,4.8,25000,10
"Hạt Chia Trắng DK Harvest (Nhập Khẩu Úc) - 300g, 500g - giàu acid béo omega-3, chất xơ, protein và chất chống oxy hoá",Thực phẩm,99000,79000,95,4.7,20000,20
Khô gà lá chanh chất lượng Tân Lộc Phát (Hũ 500G),Thực phẩm,150000,65000,336,4.5,85000,57
Trân châu caramel Déli 1kg,Thực phẩm,42000,35000,15,4.5,7000,17
Táo Đỏ Khô Cao Cấp Smile Nuts Hộp 500g,Thực phẩm,239000,75000,157,4.5,164000,69
1KG - COMBO 2 HŨ THỊT KHÔ BÒ DẠNG SỢI TÂN LỘC PHÁT - DÙNG TRỘN GỎI,Thực phẩm,200000,160000,112,3.9,40000,20
"Yến Mạch Ăn Liền Woolworths Oats Rolled - Phù Hợp Ăn kiêng, Giúp Giảm Cân, Giảm Cholesterol Trong Máu, Kiểm Soát Đường Máu, Tăng Cường Miễn Dịch - Bịch 750gr",Thực phẩm,120000,38000,9,4.8,82000,68
1 KG HẠT ĐIỀU NGUYÊN RANG TỎI ỚT GIÒN NGON LOẠI 1,Thực phẩm,150000,75000,35,4,75000,50
Lốc 5 Mì Cay Truyền Thống Samyang (140g x 5) - Hàng Nhập Khẩu,Thực phẩm,105000,88000,14,5,17000,16
Rong Biển Ăn Liền Choice L 5G (12 Gói),Thực phẩm,159000,87000,25,4.8,72000,45
Khô heo cháy tỏi loại 1 ( Giòn ngon - đậm vị ) thương hiệu Nàng Khô - 1 kí,Thực phẩm,300000,155000,117,4.2,145000,48
Khô Gà Bơ Tỏi Thơm Mùi Tỏi TETE 500gram,Thực phẩm,150000,68000,140,4.3,82000,55
Lốc 5 Gói Mì Cay Hàn Quốc Shin Ramyun Nongshim (120g / Gói),Thực phẩm,150000,89000,64,4.6,61000,41
Hạt đậu hà lan rang tỏi ớt loại 1 (Giòn ngon - đậm vị) thương hiệu Nàng Khô 500g,Thực phẩm,100000,42000,51,4.7,58000,58
Combo 2 Túi Táo Đỏ Khô Tân Cương Smile Nuts 500g,Thực phẩm,455000,145000,141,4.5,310000,68
Nam việt quất sấy DK HARVEST nhập khẩu Canada 200g,Thực phẩm,130000,109000,106,4.8,21000,16
"Hạt Diêm Mạch DK Harvest - Quinoa 300g, 500g, 1kg",Thực phẩm,180000,75000,121,4.7,105000,58
500G BÁNH GẠO TOPOKKI HÀN QUỐC,Thực phẩm,55000,55000,66,4.5,0,0
Khoai lang sấy mật ong (hàng loại 1 nguyên miếng) thương hiệu Nàng Khô - 1 kí ( 2 hũ ),Thực phẩm,200000,95000,55,4.6,105000,53
"Nhân Hạt Điều Rang DK Harvest - 250g, 500g",Thực phẩm,189000,109000,99,4.6,80000,42
Túi Nho Khô 3 Màu REAL FOOD STORE (Nhiều lựa chọn),Thực phẩm,59000,37000,256,4.5,22000,37
Đường Phèn Quảng Ngãi 3T FOOD- Hạt vừa,Thực phẩm,80000,65000,85,4.7,15000,19
Chà Là khô nguyên cành Deglet Nour Tunisia hộp 500g,Thực phẩm,210000,149000,108,4.6,61000,29
Mứt Chocolate Hạt Dẻ Nutella Spread 350gr,Thực phẩm,169000,129000,71,4.8,40000,24
"Nhân Óc Chó Đỏ DK HARVEST - Là loại hạt siêu dinh dưỡng, Có Omega 7,Giá trị dinh dưỡng cao gấp 3,3 lần so với loại óc chó thường",Thực phẩm,169000,139000,93,4.6,30000,18
Bơ Đậu Phộng Mịn Golden Farm (510g),Thực phẩm,86600,82800,121,4.7,3800,4
Bột cacao nguyên chất 100% Việt Nam - Dòng Origin thượng hạng túi giấy 500g - Heyday Cacao,Thực phẩm,176000,176000,153,4.5,0,0
"Hạt Hạnh Nhân Tách Vỏ Nướng Mộc Smile Nuts Hộp Giấy 500g - Hạnh nhân nhập khẩu từ Mỹ, nướng mộc giòn rụm, thơm ngon",Thực phẩm,225000,179000,114,4.6,46000,20
10 hũ nước Yến Sào Sanest Có Đường (70ml),Thực phẩm,390000,349000,50,4.7,41000,11
"Gạo Lứt VietGAP Vinh Hiển - túi 2KG - dẻo mềm, thơm ngon, đạt chuẩn VietGAP",Thực phẩm,42000,41000,57,4.5,1000,2
Yến Mạch Quaker Oats Quick - 1 Minute 4.52kg ( Dạng Hạt Cán Vỡ ),Thực phẩm,250000,161000,109,4.7,89000,36
"Hạt Bí Sống Dùng Làm Sữa DK Harvest nhập khẩu - Túi 500g, 1000g",Thực phẩm,179000,137000,56,4.8,42000,23
1Kg xoài sấy dẻo chua ngọt thơm ngon chứa nhiều dưỡng chất rất tốt cho sức khỏe,Thực phẩm,150000,99000,9,4.7,51000,34
Túi 12 Thanh Socola KitKat 2F (Thanh 17g),Thực phẩm,85000,75000,11,4.5,10000,12
Thức Uống Yến Mạch Quaker 3in1 - Vị Berry Burst 450g,Thực phẩm,80000,67100,108,4.6,12900,16
[TẶNG KÈM HỘP XUÂN] 1KG LẠP XƯỞNG TÔM THƯỢNG HẠNG TLP - COMBO 2 BỊCH,Thực phẩm,200000,109000,13,4.6,91000,46
Thùng 30 gói mì lẩu thái hương vị tôm 80g,Thực phẩm,240000,175000,14,5,65000,27
Lốc 5 Gói Mì Khô Gà Cay Samyang Vị Phô Mai (140g / Gói),Thực phẩm,187000,91200,5,4.2,95800,51
1KG - COMBO 2 HŨ CƠM GẠO LỨT RONG BIỂN TLP - ĂN CHAY ĐƯỢC,Thực phẩm,170000,150000,38,4.7,20000,12
Bún Gạo Lứt Hoa Sen - Hoa Sen Brown Rice Vermicelli - Hộp 400g,Thực phẩm,65000,45000,81,4.8,20000,31
Thùng 30 Mì VIFON Chính Hiệu Hai Tôm (60g / Gói) ,Thực phẩm,78000,78000,68,4.5,0,0
Lẩu tự sôi ( lẩu ăn liền ) - Lẩu trứng cút xúc xích   - chính hãng 7 Leaves,Thực phẩm,105000,95000,74,4,10000,10
Bộ 9 gói Lương Khô Quân Đội các vị ,Thực phẩm,110000,95000,102,4.5,15000,14
"Mix Nhân Hạt Khô Smile Nuts (255g - 500g) | Hạt Dinh Dưỡng đã tách vỏ gồm nhân óc chó, hạnh nhân tách vỏ và nhân hạt bí xanh",Thực phẩm,129000,90000,32,4.8,39000,30
Cơm tự sôi ( cơm ăn liền ) - Thịt Ba Chỉ,Thực phẩm,110000,89000,63,4.3,21000,19
Nhân Hạt Óc Chó Sống DK Harvest Dùng làm Sữa 1000g,Thực phẩm,725000,369000,91,4.7,356000,49
Gạo Lức Huyết Rồng Phú Minh Tâm (1kg),Thực phẩm,49000,47000,113,4.8,2000,4
500G CƠM GẠO LỨT RONG BIỂN XỐP GIÒN TLP - ĂN CHAY ĐƯỢC,Thực phẩm,150000,120000,16,4.7,30000,20
"Gạo ST25 Túi 5Kg Ông Thọ  - Cơm Thơm, Dai, Mềm Dẻo, Vị Ngọt - Đạt giải gạo ngon nhất thết giới 2019 tại Manila",Thực phẩm,199000,160000,12,4.6,39000,20
Bột Làm Kem Tươi Phổ Thông BENUSCream  ,Thực phẩm,70000,69000,55,4.5,1000,1
Bột ngũ cốc Calsome hương Vani,Thực phẩm,60000,49000,74,4.8,11000,18
Pate cho chó Petite Balade 400g (hộp) - Thức ăn thú cưng ,Chăm sóc thú cưng,120000,84000,7,4.7,36000,30
Thức ăn hạt cho mèo mọi lứa tuổi CATSRANG ,Chăm sóc thú cưng,399000,319000,417,4.7,80000,20
Cát Vệ Sinh Cho Mèo - Cát Nhật 8L (6 mùi),Chăm sóc thú cưng,180000,48000,13,4.5,132000,73
Cát Vệ Sinh Cho Mèo - Cát Nhật 8L ,Chăm sóc thú cưng,80000,50500,50,4.8,29500,37
Tã lót cho chó mèo thú cưng (có mùi hương) Sumiho công nghệ Ý (nhiều Size) Phụ kiện cho chó mèo,Chăm sóc thú cưng,290000,252000,148,4.8,38000,13
Đồ Ăn Cho Mèo Trưởng Thành Me-O Vị Hải Sản (7kg),Chăm sóc thú cưng,769000,444000,176,4.7,325000,42
Thức ăn hạt cho mèo Hàn Quốc Catsrang,Chăm sóc thú cưng,70000,36000,298,4.7,34000,49
Máy Lọc Thác Nước Dành Cho Bể Cá,Chăm sóc thú cưng,120000,65149,15,4.8,54851,46
Đồ Ăn Cho Chó Vị Gà Và Các Loại Rau Củ Pedigree Dạng Túi 1.5kg,Chăm sóc thú cưng,141300,99000,27,4.5,42300,30
"Sứ lọc bể cá (1kg) vật liệu lọc hồ cá, bể cá cảnh",Chăm sóc thú cưng,160000,37900,51,4.5,122100,76
Cát vệ sinh cho mèo cát nhật 8L 4 mùi hương [giao mùi ngẫu nhiên],Chăm sóc thú cưng,180000,46500,2,5,133500,74
Đồ Ăn Cho Mèo Con Me-O Hương Vị Cá Biển (1.1Kg),Chăm sóc thú cưng,135000,100000,287,4.7,35000,26
"(Combo 3 hộp song vị) Pate cho chó Petite Balade 400g/hộp (Pate Bò & Gà, Pate Heo & Cá Chày, Pate Gà & Cừu) nhập khẩu từ Pháp",Chăm sóc thú cưng,360000,260000,4,5,100000,28
Thức Ăn Khô Cho Chó Con Hương Vị Thịt Bò Và Sữa SmartHeart (1.5kg),Chăm sóc thú cưng,140000,97000,22,4.8,43000,31
Đồ Ăn Cho Mèo Trưởng Thành Me-O Vị Cá Ngừ (7kg),Chăm sóc thú cưng,769000,449900,236,4.5,319100,41
"Máy sủi oxy 1 vòi Electrical RS-248A ( 3W - 2.5L/PHÚT) loại tốt, siêu êm, cung cấp oxy cho bể cá cảnh mini, hồ thúy sinh",Chăm sóc thú cưng,129000,37000,5,4,92000,71
Thức Ăn Được Chế Biến Từ Thịt Tươi Cho Tất Cả Các Giống Mèo Trưởng Thành Fitmin Cat For Life Salmon 1.8KG - TẶNG 1 Lon Pate Tươi Hello Cat Pate 190G,Chăm sóc thú cưng,378000,349000,3,4.3,29000,8
"Đá nham thạch (1kg) loại đẹp, vật liệu lọc, trang trí bể cá",Chăm sóc thú cưng,70000,9998,17,4.6,60002,86
"Dụng cụ bơm tay, chuyên dùng để hút nước và vệ sinh hồ cá",Chăm sóc thú cưng,45000,24500,25,4.7,20500,46
"Sữa Tắm Chó Mèo Trị Ve Ghẻ, Bọ Chét, Rận Tai Bio (500ml)",Chăm sóc thú cưng,139000,85000,32,4.7,54000,39
Pate Tươi Dành Cho Tất Cả Các Giống Chó Ở Mọi Độ Tuổi Hương Vị Gà Thơm Ngon Dễ Ăn Bắt Vị - Hello Dog Chicken Pate 850G,Chăm sóc thú cưng,250000,230000,5,4.6,20000,8
"Thuốc Phun Xịt Ve, Ghẻ, Bọ Chét Chó Mèo Hanvet Hantox Spray (300ml)",Chăm sóc thú cưng,89000,50000,63,4.5,39000,44
"Thức ăn cho mèo con & mèo trưởng thành vị cá ngừ Minino Tuna Flavored 1,3kg",Chăm sóc thú cưng,100000,75000,81,4.7,25000,25
Tông đơ cắt tỉa lông chó mèo,Chăm sóc thú cưng,350000,180000,34,4.6,170000,49
(Combo 5 Lon) Pate Tươi Dành Cho Tất Cả Các Giống Mèo Ở Mọi Độ Tuổi Hương Vị Cá Ngừ Thơm Ngon Bắt Vị - Hello Cat Tuna Pate 190G,Chăm sóc thú cưng,350000,139000,5,4.5,211000,60
"Máy lọc nước bể cá cảnh Electrical RS188 ( 12W, 800L/H) - Máy lọc chìm",Chăm sóc thú cưng,199000,70000,16,3.6,129000,65
"Đá sỏi trồng cây, trang trí bể cá, sân vườn, bịch nửa kg",Chăm sóc thú cưng,60000,22100,10,5,37900,63
1kg cát thạch anh siêu trắng Joton Sandy cho bể cá và bể lọc,Chăm sóc thú cưng,60000,25000,72,4.7,35000,58
Combo Fitmin Cat Purity Hairball Thức Ăn Đặc Biệt Giàu Đạm Động Vật Từ Thịt Bò Và Gan Dành Cho Mèo Trưởng Thành Có Lông Dài - TẶNG 1 Lon Pate Tươi Hello Cat Pate 190G,Chăm sóc thú cưng,452000,357000,4,4.5,95000,21
Đồ Ăn Cho Chó Trưởng Thành Hương Vị Thịt Bò Nướng Classic Pets (20kg),Chăm sóc thú cưng,990000,805200,181,4.7,184800,19
Sỏi suối tự nhiên dùng trải nền hồ cá thủy sinh ( size nhỏ nhuyễn ),Chăm sóc thú cưng,50000,20000,15,4.7,30000,60
"Combo 8 miếng Mảnh ghép chuồng chó đa năng kích thước 35x35cm tặng kèm 16 chốt nhựa để lắp ghép quây chó mèo, lắp ghép kệ",Chăm sóc thú cưng,399000,125500,26,4.8,273500,69
(Combo 5 Lon) Pate Tươi Dành Cho Mèo Kén Ăn Tất Cả Các Giống Mèo Ở Mọi Độ Tuổi Hương Vị Gà - Hello Cat Chicken Pate 190G,Chăm sóc thú cưng,350000,139000,10,4.5,211000,60
Lồng Chuột Hamster,Chăm sóc thú cưng,300000,90000,85,4.5,210000,70
Sỏi ba màu tự nhiên màu đậm ( size nhỏ ) dùng trang trí hồ cá và sân vườn,Chăm sóc thú cưng,50000,17999,8,3.8,32001,64
"Sữa Tắm Chó Mèo Trị Ve Ghẻ, Bọ Chét, Rận Tai Bio (150ml)",Chăm sóc thú cưng,55000,44900,44,4.5,10100,18
Tẩy Giun Chó Mèo Hanvet Sanpet (1 Vỉ 10 Viên),Chăm sóc thú cưng,59000,51000,85,4.6,8000,14
Đồ Ăn Cho Chó Trưởng Thành Hương Vị Thịt Bò Nướng SmartHeart (10kg),Chăm sóc thú cưng,770000,524900,88,5,245100,32
san hô vụn lọc nước bể cá 1kg,Chăm sóc thú cưng,60000,8799,29,4.5,51201,85
Chuồng lồng nuôi nhốt chó mèo -LỒNG SƠN TĨNH ĐIỆN  XUẤT KHẨU NAN DÀY màu ngẫu nhiên,Chăm sóc thú cưng,269000,229000,38,4.5,40000,15
Bỉm quần vệ sinh cho chó mèo Cái (Female) Sumiho công nghệ Ý (Nhiều size) thấm hút vượt trội,Chăm sóc thú cưng,175000,140000,51,4.8,35000,20
"Máy lọc nước bể cá dạng treo, máy lọc thác kết hợp lọc váng",Chăm sóc thú cưng,150000,78500,32,4,71500,48
Đồ Ăn Cho Mèo Trưởng Thành Me-O Vị Cá Thu (7kg),Chăm sóc thú cưng,769000,459000,138,4.5,310000,40
"Giường ngủ ấm áp cho thú cưng, Nệm ngủ cho chó mèo",Chăm sóc thú cưng,300000,98000,40,4.6,202000,67
Thức Ăn Dành Cho Chó Trong Thời Kì 5 - 18 Tháng Có Hàm Lượng Năng Lượng Được Kiểm Soát Để Xương Phát Triển Khỏe Mạnh Thuộc Giống Chó Lớn Fitmin Dog Maxi Junior 3KG - TẶNG 1 Lon Pate Tươi Hello Dog Chicken Pate 190G,Chăm sóc thú cưng,399000,360000,3,4.7,39000,10
Combo 5 gói thức ăn cho chó trưởng thành Ganador vị gà nướng Adult Roasted Chicken Flavor 400gr,Chăm sóc thú cưng,110000,96000,36,5,14000,13
Sữa Tắm Cho Chó Lông Trắng SOS (530ml),Chăm sóc thú cưng,142000,79000,69,4.6,63000,44
Thức Ăn Cho Mèo Me-O Adult Vị Cá Ngừ (350g),Chăm sóc thú cưng,40000,28990,16,5,11010,28
"Combo 12 gói sốt chó Pedigree vị gà,gan và rau 80g/1 gói",Chăm sóc thú cưng,140000,140000,4,5,0,0
"Đèn led hồ cá , hồ thủy sinh ",Chăm sóc thú cưng,149000,89000,83,4.5,60000,40
"Cát thạch anh (1KG) Cát thạch anh lọc nước bể cá, nước sinh hoạt, trải nền, làm thác cát, trang trí bể cá, khử asen, tạp chất có trong nước ăn hàng ngày...",Chăm sóc thú cưng,80000,11480,8,3.9,68520,86
Cát vệ sinh cho mèo - Cát Nhật 10L,Chăm sóc thú cưng,120000,93900,8,3.9,26100,22
 Thức Ăn Hảo Hạng Có Hơn 30% Thịt Tươi Dành Cho Chó Trưởng Thành Tất Cả Các Giống Fitmin Dog For Life Adult All Breeds 3KG - TẶNG 1 Lon Pate Tươi Hello Dog Chicken Pate 190G,Chăm sóc thú cưng,350000,227000,10,4.3,123000,35
Cát Vệ Sinh Cho Mèo - Cát Nhật 8L - 6 mùi [giao ngẫu nhiên] ,Chăm sóc thú cưng,120000,46000,21,4.8,74000,62
Thức Ăn Ngũ Cốc Cho Hamster - Thức Ăn Loại Thường (500g),Chăm sóc thú cưng,60000,37000,80,4.5,23000,38
THỨC ĂN CHO MÈO MỌI LỨA TUỔI CATSRANG 3KG,Chăm sóc thú cưng,490000,285000,36,5,205000,42
Thức Ăn Dành Cho Mèo Trưởng Thành Lông Dài Hỗ Trợ Điều Trị Búi Lông Fitmin Cat For Life Hairball 1.8KG - TẶNG 1 Lon Pate Tươi Hello Cat Pate 190G,Chăm sóc thú cưng,378000,287000,0,0,91000,24
 Máy Lọc Chìm Bể Cá Cảnh 5W JY-03 (Lớn) ,Chăm sóc thú cưng,189000,95000,1,5,94000,50
Máy Lọc Thác Nước Bể Cá,Chăm sóc thú cưng,130000,79000,109,3.9,51000,39
" GĂNG TAY TẮM CHO CHÓ MÈO, (Màu ngẫu nhiên)",Chăm sóc thú cưng,29000,14500,11,3.8,14500,50
Combo Fitmin Cat Purity Urinary Thức Ăn Đặc Biệt Giàu Đạm Động Vật Từ Thịt Gà Tây Cho Mèo Lớn Có Tác Động Tốt Đến Hệ Tiết Niệu - TẶNG 1 Lon Pate Tươi Hello Cat Pate 190G,Chăm sóc thú cưng,452000,357000,2,5,95000,21
Hạt Catsrang  - Thức Ăn Hạt Cho Mèo Mọi Lứa Tuổi,Chăm sóc thú cưng,70000,50000,2,5,20000,29
Ngăn phóng uế Fay Repell 200ml,Chăm sóc thú cưng,62000,57000,40,4,5000,8
Đồ Ăn Cho Chó Vị Gà Và Các Loại Rau Củ Pedigree Dạng Túi 1.5kg,Chăm sóc thú cưng,141300,99000,27,4.5,42300,30
Thức Ăn Hạt Catsrang Cho Mèo Mọi Lứa Tuổi - 2Kg,Chăm sóc thú cưng,300000,215000,40,4.8,85000,28
Đồ Chơi Cao Su Hình Xương Có Gai Luyện Tập Răng Cho Thú Cưng,Chăm sóc thú cưng,42000,35000,3,3.7,7000,17
"Trứng Artemia Mỹ ấp nở làm thức ăn cho cá bột, cá Guppy, cá Betta - Hủ 20g",Chăm sóc thú cưng,200000,64700,9,4.1,135300,68
Thức Ăn Dành Cho Chó Đã Trưởng Thành Thuộc Các Giống Chó Lớn Có Hàm Lượng Năng Lượng Tăng Fitmin Dog Maxi Performance 15KG - TẶNG 1 Lon Pate Tươi Hello Dog Chicken Pate 850G,Chăm sóc thú cưng,1681000,1323000,1,5,358000,21
"Dung dịch nhỏ sống lưng trị ve ghẻ, bọ chét chó  - Fronil spot hộp 5 ống",Chăm sóc thú cưng,59000,47500,46,4.5,11500,19
Cát Vệ Sinh Đậu Phụ Cho Mèo ACROPET 5L - Hương Lavender,Chăm sóc thú cưng,150000,95000,28,4.8,55000,37
"Thức ăn cho cá  Guppy, cá 7 màu - Cám Thái INVE 3/5  cho cá nhỏ- chiết lẻ. rất thơm, cá ăn nhìu, mập ú, màu sắc đẹp. không đục nước.",Chăm sóc thú cưng,130000,55000,7,4.7,75000,58
Tã lót cho chó mèo thú cưng (có mùi hương) Sumiho công nghệ Ý (nhiều Size) Phụ kiện cho chó mèo,Chăm sóc thú cưng,268000,224000,148,4.8,44000,16
Bể cá mini,Chăm sóc thú cưng,299000,189000,36,4,110000,37
Xương Orgo cho chó,Chăm sóc thú cưng,50000,38000,44,5,12000,24
"Combo Máy bơm, máng lọc, dành cho hồ cá cảnh RS-288",Chăm sóc thú cưng,220000,70000,0,0,150000,68
Thức Ăn Dành Cho Chó Đã Trưởng Thành Của Giống Chó Nhỏ Có Hàm Lượng Năng Lượng Trung Bình Hỗ Trợ Giảm Cân Fitmin Dog Mini Maintenance 3KG - TẶNG 1 Lon Pate Tươi Hello Dog Chicken Pate 190G,Chăm sóc thú cưng,429000,337000,3,5,92000,21
"Bông lọc bể cá, vật liệu lọc cho bể cá (30 x 13cm) - Trắng",Chăm sóc thú cưng,35000,5999,11,5,29001,83
Cát tắm hamster,Chăm sóc thú cưng,35000,24000,31,4.6,11000,31
Lược chải lông cho chó mèo có nút loại bỏ lông thừa,Chăm sóc thú cưng,45000,37000,43,4.3,8000,18
Bỉm vệ sinh cho chó đực (dạng quấn bụng) thấm hút vượt trội,Chăm sóc thú cưng,168000,140000,29,5,28000,17
"Áo Quần Thú Cưng, Áo cho chó mèo siêu cute",Chăm sóc thú cưng,109000,59000,61,4.8,50000,46
Máy sủi oxy hồ cá LEO  27895-205 Hàng chính hãng,Chăm sóc thú cưng,295000,149000,33,4.5,146000,49
Đồ Ăn Cho Mèo Trưởng Thành Me-O Hương Vị Hải Sản (1.2Kg),Chăm sóc thú cưng,159000,114000,52,5,45000,28
Thức Ăn Dành Cho Chó Trong Thời Kì 5 - 18 Tháng Có Hàm Lượng Năng Lượng Được Kiểm Soát Để Xương Phát Triển Khỏe Mạnh Thuộc Giống Chó Lớn Fitmin Dog Maxi Junior 3KG - TẶNG 1 Lon Pate Tươi Hello Dog Chicken Pate 190G,Chăm sóc thú cưng,399000,360000,3,4.7,39000,10
"Viên Nhai Trị Ve, Ghẻ, Bọ Chét Nexgard Cho Chó 4 - 10kg",Chăm sóc thú cưng,189000,165000,39,4,24000,13
"Chậu thủy tinh, bể cá mini D14H12",Chăm sóc thú cưng,75000,56000,11,4.2,19000,25
Đồ Chơi Cho Mèo Cần Câu Đùa Giỡn Với Mèo Đẹp Mắt,Chăm sóc thú cưng,150000,27000,34,4.8,123000,82
Bỉm quần vệ sinh cho chó mèo Cái (Female) Sumiho công nghệ Ý (Nhiều size) thấm hút vượt trội,Chăm sóc thú cưng,168000,140000,51,4.8,28000,17
 Đồ Ăn Khô Cho Chó Trưởng Thành Hương Vị Thịt Bò Nướng SmartHeart (3kg),Chăm sóc thú cưng,230000,177500,152,4.6,52500,23
Catsrang 5Kg Thức Ăn Hạt Cho Mèo Mọi Lứa Tuổi,Chăm sóc thú cưng,510000,350000,3,4.3,160000,31
Đồ Ăn Khô Cho Chó Con Hương Vị Thịt Bò Và Sữa SmartHeart (3kg),Chăm sóc thú cưng,270000,218900,85,4.5,51100,19
(Combo 5 Lon) Pate Tươi Dành Cho Mèo Kén Ăn Tất Cả Các Giống Mèo Ở Mọi Độ Tuổi Hương Vị Gà - Hello Cat Chicken Pate 190G,Chăm sóc thú cưng,350000,139000,10,4.5,211000,60
Nhỏ gáy trị ve rận chó mèo 2.5ml cho thú cưng dưới 10kg,Chăm sóc thú cưng,25000,24000,23,4.5,1000,4
Vòng cổ chó mèo nhiều màu sắc (giao ngẫu nhiên),Chăm sóc thú cưng,30000,20000,18,4.8,10000,33
Đèn bể cá loại chìm dành cho hồ cá cảnh có công tắc dễ sử dụng,Chăm sóc thú cưng,159000,98000,80,4.5,61000,38
Tẩy Giun Chó Mèo Hanvet Sanpet (1 Vỉ 10 Viên),Chăm sóc thú cưng,59000,51000,85,4.6,8000,14
Đồ Ăn Cho Mèo Lớn Whiskas Vị Cá Thu Túi 1.2 Kg ,Chăm sóc thú cưng,155000,107000,25,4.8,48000,31
"Máy bơm nước bể cá RS-1680F, đầu máy bơm, máy lọc, máy bơm chìm làm quạt điều hoà (25W, 1750L/H)",Chăm sóc thú cưng,150000,84880,18,4.3,65120,43
Bộ 10 Thanh Sứ Lọc Bể Cá DJ301 (Vàng),Chăm sóc thú cưng,200000,56480,11,4.3,143520,72
 Thức Ăn Hảo Hạng Có Hơn 30% Thịt Tươi Dành Cho Chó Trưởng Thành Tất Cả Các Giống Fitmin Dog For Life Adult All Breeds 3KG - TẶNG 1 Lon Pate Tươi Hello Dog Chicken Pate 190G,Chăm sóc thú cưng,350000,227000,10,4.3,123000,35
"Máy thổi oxy tích điện 1 vòi ĐỀ PHÒNG CÚP ĐIỆN  SB-168 thích hợp cho hồ cá cảnh, hồ thủy sinh và đi câu cá",Chăm sóc thú cưng,250000,129999,16,5,120001,48
"Sữa Tắm Cho Chó SOS - Phục Hồi Da, Lông (530ml)",Chăm sóc thú cưng,142000,79000,28,4.5,63000,44
"Than hoạt tính lọc nước bể cá (1kg) vật liệu lọc nước sinh hoạt, vật liệu lọc bể cá, xử lý khí thải, khử độc",Chăm sóc thú cưng,98000,37580,10,4.7,60420,62
Combo Fitmin Cat Purity Urinary Thức Ăn Đặc Biệt Giàu Đạm Động Vật Từ Thịt Gà Tây Cho Mèo Lớn Có Tác Động Tốt Đến Hệ Tiết Niệu - TẶNG 1 Lon Pate Tươi Hello Cat Pate 190G,Chăm sóc thú cưng,452000,357000,2,5,95000,21
Bể cá để bàn - 30x17x17 tặng phụ kiên- hồ cá mini,Chăm sóc thú cưng,189000,149000,11,4.5,40000,21
"Máy bơm nước bể cá RS-1200, đầu máy bơm, máy lọc (8W, 800L/H)",Chăm sóc thú cưng,140000,65480,12,4.3,74520,53
Thức Ăn Cho Mèo Con Royal Canin Kitten (2kg),Chăm sóc thú cưng,446000,397000,18,5,49000,11
"Combo thức ăn cho chó Pedigree 1,5kg vị thịt bò và rau củ + sốt chó lớn Pedigree 80g vị bò nướng và rau",Chăm sóc thú cưng,150000,105000,4,4.5,45000,30
Dây dắt yếm cho chó mèo nhỏ (màu ngẫu nhiên),Chăm sóc thú cưng,35000,22000,30,4.5,13000,37
Artemia Tách Vỏ Sấy Khô - Thức Ăn Cá Cảnh 150ml (80g),Chăm sóc thú cưng,70000,60000,2,5,10000,14
"Thuốc Trị Ve Ghẻ Nhỏ Sống Lưng, Nhỏ Tai Chó Vemedim Fronil Spot",Chăm sóc thú cưng,69000,49000,49,4.7,20000,29
"500ml Vi sinh PSB làm trong nước bể cá (Vi khuẩn quang hợp, vi sinh tươi)",Chăm sóc thú cưng,44850,39900,0,0,4950,11
Tông đơ chó mèo cạo lông thú cưng + Bộ nhiều phụ kiện tỉa móng - Sói bạc AGD-P60,Chăm sóc thú cưng,560000,349000,15,4.5,211000,38
Nhà Ngủ Gỗ Lắp Ráp + Nệm Sky Mini dành cho dòng chó mèo nhỏ,Chăm sóc thú cưng,300000,240000,1,5,60000,20
"Combo đá nham thạch (1kg) + san hô vụn (1kg) vật liệu lọc, trang trí bể cá",Chăm sóc thú cưng,169000,18000,5,3.8,151000,89
Thức ăn cho chó trưởng thành Ganador vị gà nướng Adult Roasted Chicken Flavor 3kg,Chăm sóc thú cưng,155000,129000,5,5,26000,17
"Lọ vi sinh quang hợp cho bể thủy sinh, cá cảnh",Chăm sóc thú cưng,200000,100020,9,4.2,99980,50
Chuồng pet gấp gọn - lồng nuôi chó mèo sơn tĩnh điện tặng kèm khay vệ sinh,Chăm sóc thú cưng,250000,148000,6,3.8,102000,41
Thức Ăn Cho Mèo  Me-O Adult Vị Cá Thu (350g),Chăm sóc thú cưng,35000,29000,12,4.8,6000,17
"Dung dịch phun xịt diệt bọ chét, trứng bọ chét, con bét, con ve, rận chấy ở chó mèo Fiprofort Spray 250ml",Chăm sóc thú cưng,190000,170000,22,4.6,20000,11
Bể cá mini để bàn làm việc,Chăm sóc thú cưng,799000,357000,6,4.3,442000,55
Đồ Ăn Cho Chó Trưởng Thành Classic Pets Hương Vị Thịt Bò Nướng (2kg),Chăm sóc thú cưng,139000,112800,105,4.7,26200,19
"Keo bẫy chim siêu dính, không độc hại",Chăm sóc thú cưng,90000,15500,12,4.3,74500,83
Sữa tắm hương nước hoa cao cấp cho chó mèo Spirit 500ml,Chăm sóc thú cưng,185000,125000,3,3.7,60000,32
"Nano bạc thủy sinh Fin+ Làm sạch bể cá, diệt khuẩn phòng bệnh cá Cảnh, cá Koi",Chăm sóc thú cưng,42000,39000,14,4.3,3000,7
MEN VI SINH COMPOZYME DÀNH CHO HỒ CÁ CẢNH,Chăm sóc thú cưng,80000,24999,29,4.5,55001,69
"Combo máy bơm, máng lọc, RS 7800 cho hồ cá cảnh ",Chăm sóc thú cưng,300000,168000,8,4.5,132000,44
Combo 5 gói thức ăn cho chó con Ganador vị sữa & DHA Puppy Milk with DHA 400 gram,Chăm sóc thú cưng,145000,122999,36,4.6,22001,15
CHUỒNG CHÓ MÈO 60*43*50cm SƠN TĨNH ĐIỆN,Chăm sóc thú cưng,600000,285000,15,4.8,315000,53
"Sữa Tắm Chó Mèo Siêu Mượt Lông, Khử Mùi Bio (500ml)",Chăm sóc thú cưng,119000,95000,38,4.6,24000,20
Men vi sinh  Bio 500ml,Chăm sóc thú cưng,250000,144990,4,4.3,105010,42
"Thức ăn cho mèo Minino Tuna Flavored thùng 7,8kg (6 túi*1,3kg)",Chăm sóc thú cưng,595000,430000,57,4.8,165000,28
Đèn bể cá LED ĐỔi MÀU 4 dãy led cho hồ cá cảnh,Chăm sóc thú cưng,199000,99000,99,4.6,100000,50
Lưới Bẫy Chim Tổng Hợp cao 5m,Chăm sóc thú cưng,160000,45000,0,0,115000,72
Đèn bể cá đèn chìm tự động đổi màu cho hồ cá thêm sinh động,Chăm sóc thú cưng,129000,79000,30,4.2,50000,39
Bể cá MJ260 - giao mầu ngẫu nhiên,Chăm sóc thú cưng,799000,495000,8,4.1,304000,38
"Xúc xích ăn vặt cho chó mèo, gói 30 cây",Chăm sóc thú cưng,80000,55000,51,4.7,25000,31
Thức Ăn Hạt Cho Mèo Thái Lan Hello Cat Tuna 1.2Kg - Tặng Lon Pate Hello Cat 190G,Chăm sóc thú cưng,155000,105000,30,4.3,50000,32
Cát vệ sinh Nhật Bản Cat Litter 10L dành cho mèo (Giao mùi ngẫu nhiên),Chăm sóc thú cưng,155000,108900,4,4.3,46100,30
Combo 6 bịch cát vệ sinh cho mèo - Cát Nhật 8 L (Giao mùi ngẫu nhiên),Chăm sóc thú cưng,350000,275000,8,4.6,75000,21
Máy bơm nước bể cá ATMAN AT-306s( 27W - 2000l/h) siêu bền,Chăm sóc thú cưng,600000,245511,4,3.8,354489,59
Thức ăn cho chó trưởng thành Ganador vị thịt cừu & gạo Lamb & Rice 3 kg,Chăm sóc thú cưng,165000,141000,34,5,24000,15
"Đá nham thạch (2kg) vật liệu lọc, trang trí bể cá",Chăm sóc thú cưng,149000,23090,7,4.5,125910,85
thức ăn cho cá Shanghai 500g,Chăm sóc thú cưng,50000,13500,0,0,36500,73
Combo 12 Gói Thức Ăn Cho Mèo Con Whiskas Vị Cá Ngừ Dạng Túi (85g),Chăm sóc thú cưng,162500,155000,17,5,7500,5
Dây dắt vải đan bền cho thú cưng (màu ngẫu nhiên),Chăm sóc thú cưng,75000,29670,29,4.5,45330,60
"Máy thổi luồng Sobo-WP800M (25W - 20.000 L/H) tạo dòng nước, làm sạch chất bẩn trong hồ",Chăm sóc thú cưng,400000,220000,3,4.7,180000,45
Thức ăn hạt cho mèo con Hàn Quốc Catsrang Kittten,Chăm sóc thú cưng,70000,60999,86,4.8,9001,13
Đồ Ăn Cho Mèo Trưởng Thành Me-O Hương Vị Cá Thu (450g),Chăm sóc thú cưng,65000,54300,16,4.8,10700,16
Vòng nổi chứa thức ăn cho cá phụ kiện bể cá,Chăm sóc thú cưng,49000,35000,9,5,14000,29
Máy sủi oxy mini 2 vòi SOBO SB-348A (5W - 8L/PHÚT),Chăm sóc thú cưng,179000,77880,4,3.8,101120,56
Thức ăn cho chó con Ganador vị Trứng và Sữa - Egg and Milk 400 gr,Chăm sóc thú cưng,26000,26000,23,5,0,0
Xương da bò gặm sạch răng cho chó,Chăm sóc thú cưng,77900,36269,11,4.2,41631,53
Xẻng cán thẳng xúc cát vệ sinh – Xẻng xúc chất thải cho mèo - Giao màu ngẫu nhiên,Chăm sóc thú cưng,42000,17000,4,5,25000,60
Mô hình cầu non bộ trang trí bể cá phụ kiện thiết bị bể cá cảnh quan bể cá trang trí nhà cửa lũa bể cá thủy sinh,Chăm sóc thú cưng,269000,89000,5,4.6,180000,67
"Xương Gặm Đồ Chơi Có Thể Ăn Được Orgo – Bịch 90g 5 Thanh - Dành Cho Chó Giúp Làm Sạch Răng Và Thơm Miệng Hình Bàn Chải Ngộ Nghĩnh 3 Vị Bò, Sữa Và Bạc Hà Xudapet – XBC01",Chăm sóc thú cưng,130000,28600,8,4.5,101400,78
Bể cá mini để bàn combo 2 Bể tặng phụ kiện,Chăm sóc thú cưng,130000,99000,41,4.5,31000,24
Đồ Ăn Cho Chó Vị Thịt Gà Và Gan SmartHeart (Hộp 400g),Chăm sóc thú cưng,55000,43700,49,4.7,11300,21
Cát vệ sinh mèo McKelly 5L,Chăm sóc thú cưng,85000,70000,43,4.8,15000,18
Vòng cổ đệm cho chó (Chọn 4 màu) - Vòng cổ chó mèo 5 size thích hợp mọi loại chó,Chăm sóc thú cưng,99000,34900,0,0,64100,65
"1KG Cát thạch anh lọc nước bể cá, nước sinh hoạt, trải nền, làm thác cát, trang trí bể cá, ",Chăm sóc thú cưng,79000,14480,3,3.7,64520,82
 Combo 24 túi mix 4 vị thức ăn pate cho mèo lớn Whiskas 85g/túi,Chăm sóc thú cưng,264000,264000,6,5,0,0
Sữa Tắm Cho Chó SOS - Giúp Mềm Mượt Lông (530ml),Chăm sóc thú cưng,142000,79999,56,4.3,62001,44
Combo 5 gói thức ăn cho chó trưởng thành Ganador vị thịt cừu & gạo Lamb & Rice 400gram,Chăm sóc thú cưng,125000,102887,24,4.7,22113,18
THỨC ĂN HẠT CHO MÈO NHỎ CATSRANG KITTEN 1.5KG - NHẬP KHẨU HÀN QUỐC,Chăm sóc thú cưng,280000,205000,13,4.8,75000,27
Balo Phi Hành Gia trong suốt cho chó mèo (giao màu ngẫu nhiên),Chăm sóc thú cưng,500000,229000,2,5,271000,54
Đồ Ăn Cho Chó Vị Gà Và Các Loại Rau Củ Pedigree Dạng Túi 1.5kg,Chăm sóc thú cưng,141300,110000,68,4.6,31300,22
Thức ăn mèo lớn Royal Canin Indoor 2kg,Chăm sóc thú cưng,460000,390000,28,4.8,70000,15
Tấm lót vệ sinh cho chó mèo,Chăm sóc thú cưng,215000,190000,4,5,25000,12
Nệm ngủ cho chó,Chăm sóc thú cưng,200000,73500,8,3.9,126500,63
Tiểu cảnh bể cá để bàn kèm đồng hồ TG-03M,Chăm sóc thú cưng,650000,640000,0,0,10000,2
Cát vệ sinh cho mèo Genki 5L,Chăm sóc thú cưng,68000,54740,12,4.5,13260,20
